ANT	dA	POST	TAG
Vazgeçmek kolaydı , ertelemek	de	.	NDC
Ben bu duvarı taşıyan birçok insan gördüm ve aşmaya değil yıkmaya çalıştım ; ama ne ben haberdardım bu duvarın yıkılamayacağından ne de duvarı taşıyan haberdardı bu duvarı taşıdığından . Sen	de	haberdar değildin ve ben hayatımda ilk kez yıkmaya değil aşmaya çalışıyordum .	DC
Köşede duran eski kırık kurnaları ve tuvalet taşlarını görünce hemen işe girişti . Bunları ses çıkarmamaya çalışarak düzenledi . Kuşku uyandırmamak amacıyla eski hallerini	de	pek bozmadan kolay kolay fark edilemeyecek güvenli bir köşe oluşturdu .	DC
Hamamcı ıslak peştamal ve havluyu sepete atarken takunyaların nasıl kuru kaldığına şaşırdı .      Halil gecelerce uğraşarak belirlediği yere bir delik daha açtı . Deliği açtığı yerde	de	eski takunyalar yığılıydı . Bunların altındaki delik en az öbürü kadar güvenliydi .	NDC
Halil bir gün yine saatlerce meyhanenin mahzeninde Ante ile içip dertleştikten sonra ağır ağır nakışçıya yürüdü . Kafasında kendi derdinin yanında Ante ' ninki	de	vardı .	NDC
Senin nerede olduğunu bildiğini söylüyor ve hatta tam adresini bile veriyordu . Bu adreste seni bulamayacağımı	da	ekliyordu .	DC
Artık kendi evinde kalmadığını , son zamanlarda birlikte olduğun bir adamın evine taşındığını , istersem bu adresi	de	bulabileceğini söylüyordu .	DC
Ben kıvranacaktım , ben acı çekip işkencelere gönüllü katlanacaktım senin yerine , sen bilmeden . Benim yüreğim	de	duvar taşıyordu . Aşmaya yeltenen olmadı .	NDC
Dükkânın sonunda adamın kızı bir müşteriye oya örnekleri gösteriyordu . Halil ' in geldiğini fark etmediler . Halil	de	içtiği içkilerin etkisiyle kadınlara bir şaka yapmaya karar verdi .	DC
Hepsi sakatlığımı anımsatacak kelimelerden özenle kaçınıyordu . Ben	de	özenle sakatlığımı anımsatacak cümleler kuruyordum geçmişe ilişkin görüntüleri hatırlatarak .	DC
Hiç kıpırdamadan oturuyordun . Bir şeyler anlatacaktın , ama öyküyü bitirmemi bekliyordun . Ben	de	parçası olduğum bu oyunu bozmadım . Öyküye devam ettim .	DC
Tezgâhın arkasına girerek kadınların olduğu tarafa dolandı . Birden önlerine çıkıp onları korkutacaktı . Başka kimse olmadığından iki kadının	da	yüzü açıktı . Halil onları korkutacağı yere geldiğinde donakaldı . Elleri , ayakları titremeye başladı .	NDC
Yalnızca tırmanıyordum ardıma bakmadan , belki	de	bakmaya cesaret edemeden .	NDC
Şemsî Ahmed Paşa onu ayakta karşılayarak , başına gelen talihsiz kazaya çok üzüldüğünü , eğer hasta olursa bunun sorumluluğunun kendisinde olduğunu söyledi . Aile hekimleri Bosnalı Kerim Bey ' in hizmetine verildiğini	de	ekledi . Hemen sıcak bir ıhlamur ikram ettiler .	DC
Mihriban Hanım babasından aldığı izinle yüzünü açmıştı . Ante bu hanımefendinin güzelliğine ve zarafetine hayran kalmıştı . Konaktan ayrılırken yüreğinde bir sızı duyuyordu . Aynı sızı konaktaki Mihriban Hanım ' ın yüreğinde	de	vardı .	DC
Ermeni Ante , Şemsî Ahmed Paşa ' nın isteğiyle konağa taşındı . Konakta özenli bir bakımla kısa sürede düzeldi . Ne var ki bedenindeki yaraları Hekim Bosnalı Kerim Bey	de	görmüş ve böyle bir şeyle ilk kez karşılaştığını söylemişti .	NDC
Kör karanlığa bürünen mahzende bir süre sesleri dinledi . Önce bir şey duymadığını sandı , ama seslere	de	karanlığa olduğu gibi , zamanla alışılıyordu .	NDC
Ante de Halil ' in Sadi Bey ' in oğlu olduğunu öğrendiğinde şaşkınlığını gizleyemedi . Ressam Halil çizdiği tabloları Ante ' ye getiriyor , onun	da	düşüncelerini öğreniyordu .	DC
Halil , bu garip yaratığın adının her yerde duyduğu  ' Ermeni Ante '  olduğunu öğrenince inanamadı . Ante	de	Halil ' in Sadi Bey ' in oğlu olduğunu öğrendiğinde şaşkınlığını gizleyemedi .	DC
Çarpışma sürerken bile onun yüzünü görüyordu . Sonuçsuz bir çarpışma sonrası iki donanma	da	geri çekilerek toparlanmaya başladı . Yeni bir çarpışma olacaktı .	NDC
Şemsî Ahmed Paşa müstakbel damadının denizlerdeki başarısından sonra ticari hayatta	da	dillere destan işler yapmasıyla iyice iştahlanmıştı .	NDC
Artık bulunduğu yeri değiştirmeliydi . İnsanların onu bulamayacağı bir yere gitmeliydi , ama Mihriban ' ı	da	bırakamazdı .	NDC
İstanbul kadısının görevlendirdiği kişi ya	da	bizzat kendisi , limana giren gemilerdeki malların fiyatlarını açıklamadan önce Ermeni Ante ' yle görüşüyordu .	NDC
Neredeyse İstanbul ' un en gözde bekârı sayılan Ermeni Ante ' yi damadı olarak görmek , ona hem mutluluk , hem	de	daha seçkin bir mevki getirecekti .	NDC
Garip bir dildi bu . Belki	de	dil değildi , saçmalıyordu .	NDC
Ne geziyorsun benim mahzenimde ! Anahtarı nereden buldun ? - " Abid Efendi . Şarap ...  fıçı ...  apteshanede	de	ondan ! " - " Tamam , kekeleme . Gördün işte . Altına etmeden git artık ! "	NDC
Henüz çok iyi öğrenememiştim New York metrosunu ama gene de her gece gideceğim yere varabiliyordum . Benimle aynı saatlerde bazen bir kör adam	da	biniyordu metroya .	DC
Ter içindeydi adam ; anlatamayacağım denli çeşitli figürler yapıyor ; kadına sımsıkı sarılıyordu arada . Bazen elini kadının beyaz külotunun içine	de	sokuyordu .	DC
Ne kadar ilginç çıkmış sizin falınız . Görkemli bir ev , ışıl ışıl bir hane ...  Hanenin içinde bir adam ...  Düşüncelere dalmış . Bir başka tarafta dört kişi arasındasınız sanki ...  durun bakayım , bunlar	da	erkek .	NDC
 " Hakikaten , bir şey sezdim sesinde . "       " Biliyorsun , eskiden beri ben de beğenirdim seni , " dedi Fevzi .      Gülmeye başladım . “Niye gülüyorsun , ben	de	şerefli bir büyükelçiyim…”	DC
 Bahçesindeki manolya ağaçlarını ve özel sub-tropik bitkileri sen diktirdin . Unuttun mu yahu , geçen sonbahar orada bir parti vermiştiniz ; ben	de	vardım . Evi gezdirmiştin ya bana .	DC
Ama ben bu kadını tanımıyorum ki ! Ben Mithat Bey ' in eski karısını hiç tanımadım ki . Üstelik ben Mithat Bey ' i        de        tanımıyorum .        - Bir sessizlik oldu . Hacı Murat , O zaman sizden nefret eden , size kin duyan bir kadın	da	yok . Var ! " diye bağırdım . " Öyle bir kadın var ! Ama o başkası ! "	NDC
 Ama ,  dedi İzzettin , " Size çok güzel bir hayat sunuluyor . Varlık , kimlik ; ne bileyim ben , her şey ...  Böyle bir cinayet olamaz . " Bana yepyeni bir hayat sunuluyor , içine	de	girmiş bulunuyorum .	DC
Bir ayağı fincanın dışında sanki ! İşte öbür ayağını	da	kenardan dışarıya attı !	DC
 Buradayım , geldim işte !  dedi Fevzi . Aman , yollar	da	çamurlu mu neydi , tam anlayamadım ; ayakkabılarım , pantolonumun paçaları battı .	DC
 Sen Mithat Bey ' i ne kadar tanıyorsun ?   " Uzun yıllardır tanırım Mithat ' ı . İyi arkadaşımdır . Sen	de	bunu bilirsin . "  " Bilmiyorum , sen anlat . Ne iş yapar Mithat Bey ? "	DC
Çok mal varlığınız olduğu söylenir . Patara ' da ev yaptırıyormuşsunuz . Benim bildiklerim bu kadar . Eskiden oturduğunuz , Gaziosmanpaşa Hatır Sokak ' taki villanız	da	öylece duruyor .	NDC
Şimdi Fevzi ' den öğrendiğim şeyleri düşünüyordum . Hanımelinden gelen tatlımsı koku	da	gece bastırınca balkonu iyice doldurmuştu .	NDC
 Benim yerime , benim yaşamıma kim geçti acaba ?  Belki	de	bütün bu olanlar , benim yaşamıma birini yerleştirmek için kurulmuş bir oyun ...  "	NDC
Ama göremedim onu . Galiba gelmemiş , öyle söylediler , " dedim .      " Ah ! " diye mırıldandı Kerem . " O insanı deli eden bekleyiş . O gerilim , o yürek çarpıntısı ...  Öyle kolay gelmez ki o . "       " Sanırım o zaman	da	gelmemişti . "	NDC
 " Parkta onu bekleyen diğer erkekleri kıskanmıyormusun ? "      Bir an durdu .      " Hiç düşünmedim bunu , " dedi doğallıkla .      " Oradakilerin hepsi senin gibi . Hepsi onu bekliyor . "       " Zaman . Herkesin zamanı önemli , " dedi Kerem .      " O ne demek ? " Parkta geçmiştekiler	de	var . Onun geçmişindeki erkekler ...  Kimi bir saatlik , kimi birkaç günlük .	NDC
Muammer , yarım şişe viski olacaktı dolapta , getir onu oğlum . Arka tarafta olacak . Bardak	da	getir .	DC
 Ne kadar yazık . Galiba hiçbir şey anlatamadan gideceğim buradan ,  diye mırıldandı . " Niçin geldim buraya bilmiyorum . Sizleri	de	boşuna oyaladım . "	DC
Bazı geceler kulağımı kapısına dayar, dayak yerken attığı çığlıkları dinlerdim. Sonra barışırlardı. Ne tuhaf bir şeydi bu! Sonra da bu parka düştüm işte. Onu döven adam	da	şurada , şu ağacın altındaki .	DC
Ne tuhaf bir şeydi bu! Sonra da bu parka düştüm işte. Onu döven adam da şurada, şu ağacın altındaki. O	da	burada bekler . Sürünür şimdi .	DC
Onu döven adam da şurada şu ağacın altındaki . O da burada bekler . Sürünür şimdi . İkimiz	de	aynı durumdayız , demişti , " dedi . "	NDC
Kurtulup buraya gelmeyi başardım . Kaçtım . Erkekler Parkı ...  Ne kadar ürkütücü ve bir o kadar	da	çekici bir yer orası .	NDC
Korku içindeyim . Belki	de	bir daha bulamayacağım orayı .	NDC
Ağzından çıkanı iki ettirmezdim . Belki	de	ona karşı çok iyi olduğum için bıraktı beni .	NDC
Kerem hayretle,          "Nereden biliyorsunuz?" diye sordu. "Gerçekten çeker mi beni o parkın içine?"          "Çeker . "  " Şimdi düşünüyorum	da	, galiba o parkın dışında yapamayacağım ben , " dedi Kerem .	DC
Bu işleri yapmayanı erkekten saymıyor İlhami . Onu	da	zorluyorlar .	DC
İlhami ' nin iki çocuğu var şimdi . Yenik düşmüş bu haydut , o köpekleri anımsıyor mu zaman zaman ve ilk karısı Suzan ' ı ? Çocuklarının	da	bir gün aynı yolu izleyebilecekleri aklına gelmiyor mu hiç ?	NDC
Yalnız Mustafa değil , Hayri , Osman Mesut	da	oluyor yanında .	NDC
Ben en çok Tommiks ' le Teksas okurdum . Kinova ' yı	da	severdim ama , o , zaman zaman Kızılderililere çok kötü davranırdı .	DC
Pantolonunun arkasının diz kıvrımlarına dek çamur benekleriyle bezendiğinden kuşkusu yok . Önemi	de	yok bunun ; o benekler ensesine dek tırmansın isterse , ne değişir ki ...	DC
 Amaan ,  diyor Nesli koluna yeniden asılarak , " İyi atıyorsun , soprano teyzelerinin İtalya serüvenlerine ne zaman geçeceksin . " Keyifsiz olduğu günler	de	konuşuyor Vedat , ama daha az . " Sanayi çarşısına gidelim , " diyor örneğin , ...	NDC
Evlerin çatılarında polisler var . " Dağılmayın arkadaşlar ! Dağılmayın ! " Panik başlıyor . Vedat	da	kaçıyor . Neslihan yok . O katılmıyor .	DC
... sigarayı baş ve orta parmağının yardımıyla ileri doğru fırlatan , karanlık salonda bir yıldız gibi kayan izmaritin ardından küçük , sessiz , ama isterik kahkahalar atan -birinin ensesine girmeli , mutlaka girmeliydi- Vedat	da	yerine göre pantolon düğmelerini çözüp çükünü çıkarmamış mıydı ?	DC
Tabela yazıyorum , biliyor musun ? Komşu bakkalın tabelasını ; salt can sıkıntısından , iş olsun diye yenileyince beğenip isteyenler oldu . Adım tabelacıya çıktı . Üç-beş	de	kazancım oluyor .	DC
 İnan ki ,  diyor . " Ben ip cambazı olduğunu sanıyordum , " diyor Nesli	de	.	DC
Ayı uçup gidecek , bir daha da geri dönmeyecek . " Bir Sıntır ' ı tanıtacağım sana , " diyor ; Nesli	de	, " Kimi kimi ? " deyip asılıyor koluna .	DC
İki sinema vardı burada ; çocukluğunun ayakta kalabilmiş iki tanığı . İkisini	de	aynı kişi işletirdi .	NDC
Yürümesini bilmeyenler , ayakkabılarına yan basanlar ve yağmurlu havalarda çoraplarına ya	da	pantolonlarına çamur sıçratanlar ,	NDC
dış görünüşleri ne olursa olsun sınıfsal konumlarını ele verirler demiştin	de	kahkahalarla gülmüştü Neslihan .	DC
Kahvede , pencere önündeki masalardan birinde oturuyorsa -genç kız ve kadınları yaralayan bıçak gibi bakışlar fırlatırdı ordan- sesleniyor ; " Gel	de	bir çay iç , " diyor . Çoğunlukla gitmiyor yanına ; " İşim var , " diyor . " Yorgunum , " diyor .	DC
Kimi başını eğerek selamlıyor onu İlhami , kimi	de	sağ elini büküp parmaklarının ucunu hafifçe şapkasının siperine götürerek .	NDC
Bir namaz tahtasına sarılmış olarak kıyıya vurduğunda kollarını zor açmışlar, yarı yarıya donmuş. Belki	de	o anda Tanrı ' ya yakarıp yardım istiyordu , çünkü çok dindar bir adamdı .	NDC
Biz yasalar karşısında evli sayılacaktık , ama gerçekte evli iki insan gibi değil	de	 aynı evi paylaşan iki öğrenci gibi yaşayacaktık .	NDC
Bir zaman önce , ama çok zaman önce , onların köyüne gittiklerini , belki	de	kaçtıklarını ya da saklandıklarını -yok , avlanmak içindi , anımsıyor , çifteler ellerinde , karlarla kaplı bir düzlükte yürümüşlerdi- hayır tabela için değil , bir tuvale içini dökecekti .	NDC
O sandalyeler bile değişmemiştir, bunca şey değişir, çözülüp giderken. Bir pazar matinesinde, yıllar önce, öndeki sırada kafaları sıfır numara tıraşlı askerler otuzbir çekerlerken, beşi birden sıra ile birlikte nasıl da gerisin geri devrilmişlerdi... Herkes gülerken , kimi	de	yuh çekerken -askerdir , hoş görülür aslında- onlar da önlerini kapamaya çalışırken neye uğradıklarını şaşırmışlardı .	NDC
Kimi gün Mustafa ile geçiyor aynı sokakları . Dudaklarında sigaralar , elleri ceplerinde . Nâzım ' dan şiir okuyor Mustafa , kimi zaman	da	Ahmed Arif ' ten .	NDC
Cenazesine katılamadı . Bir zaman önce , ama çok zaman önce , onların köyüne gittiklerini , belki de kaçtıklarını ya	da	saklandıklarını -yok , avlanmak içindi , anımsıyor , çifteler ellerinde , karlarla kaplı bir düzlükte yürümüşlerdi- hayır tabela için değil , bir tuvale içini dökecekti .	NDC
Bir zaman önce, ama çok zaman önce, onların köyüne gittiklerini, belki de kaçtıklarını ya da saklandıklarını -yok, avlanmak içindi, anımsıyor, çifteler ellerinde, karlarla kaplı bir düzlükte yürümüşlerdi- hayır tabela için değil, bir tuvale içini dökecekti. `Benim Anlatmalarım '  ya	da	yalnızca `Anlatmalarım '  adını vereceği bir dizi resim yapmayı tasarlıyordu .	NDC
 Söyle Osman Efendi, ben artık cehennemlik miyim? Şarap içtim , adı kilise ya	da	papaz adına benziyordu , şişeden şarap içtim , okul kaçkınıydım .	NDC
Elektrik kesintisi nedeniyle ortaya çıkan gösterim aksamalarında ya	da	ses düzenindeki bozukluklarda salon ayağa kalkardı .	NDC
Elektrik kesintisi nedeniyle ortaya çıkan gösterim aksamalarında ya da ses düzenindeki bozukluklarda salon ayağa kalkardı . Islıklar bağırtılar ve Niyazi'ye çekilen yuhlar . Ya	da	 Niyazi ses !  çığlıkları .	NDC
Hatta bir bilet alıp o salona girse , film o anda gösteriliyor olsa ( Kızılderilileri acımasızca katleden John Wayne ya	da	dişleri arasına sıkıştırdığı bir kamayla timsahların kaynadığı suya dalan Tarzan ) ve el yordamıyla oturacak bir yer arasa kendine ...	NDC
Bir pazar matinesinde , yıllar önce , öndeki sırada kafaları sıfır numara tıraşlı askerler otuzbir çekerlerken , beşi birden sıra ile birlikte nasıl	da	gerisin geri devrilmişlerdi ...	NDC
Hadi bir kat daha , sana kahve yapacağım . Ama çok içmedim . Ötesi yoksa öteye gidemezsin bunu biliyorsun . Bir gün başkaları	da	bilip anlayacaklar ne ki iş işten geçmiş olacak . Kim başkaları ? Başkaları yok . Sonsuz bir karışıklık ve sonrasızlık hepsi bu .	DC
Belki de ilişkileri bana söylediğinin ötesindeydi	de	o gece Eda ' nın kalkıp benimle gelmesine bozulmuştu .	DC
Sinirlerim bozuluyor , diyor Tuğçe , iştahım kesik , uykusuzluk çekiyorum ve çok umutsuzum . Elini ver	de	falına bakayım , diyor Meltem .	DC
Uygunsuz bir zamanda aramış olduğumu düşündüm . Belki	de	Fulya ' yla birlikteydi .	NDC
Bana bak , onu hiç tanımıyorsun . Belki	de	sana uygun biri değil tamam mı ?	NDC
aşlangıçta benden yana olup Eda ' yla tanışmamı sağlayan Metin ' in şimdi aramızda gelişebilecek herhangi bir yakınlığa tavır alıyormuş gibi davranması ve konuşmamızı telefonu kapatarak bitirmesi çok canımı sıkmıştı . Belki	de	ilişkileri bana söylediğinin ötesindeydi de o gece Eda ' nın kalkıp benimle gelmesine bozulmuştu .	NDC
Duruşunu anımsadım , kayıtsız , gizlice pervasız ama gene	de	ölçülü .	NDC
Duruşunu anımsadım , kayıtsız , gizlice pervasız ama gene de ölçülü . Belki	de	bana olan duyarsızlığı , önemsemezliği , yerime koyacağı bir başka erkek ya da yeğleyebileceği farklı durumların tümünü derin bir aldırışsızlıkla bir yana itmişliğiyle açıklanabilirdi .	NDC
Onun dün sabah bu yatakta uyandığı ve buradan çıkıp gittiği âna kadar neler düşündüğü , neler duyduğu hem benim için hem	de	olacaksa geleceğimizi belirlemesi açısından çok önemliydi .	NDC
Doğduğun saati biliyor musun ? Metin piposunu cam küllüğe sertçe vurarak boşaltıyor . hem etnik gruplar hem	de	yaşama biçimi ve kültürleri toplamı olarak bakıldığında farklılıklar arasında birlikte yaşama geleneği sağlanamamış ve biz-onlar ayrımı ... Erkböke soluklanıp bir yudum su içiyor.	NDC
Telefon rehberindeki bütün Sezerlere baktım . Melike ya	da	Eda adına bir kayıt yoktu .	NDC
Belki de bana olan duyarsızlığı , önemsemezliği , yerime koyacağı bir başka erkek ya	da	yeğleyebileceği farklı durumların tümünü derin bir aldırışsızlıkla bir yana itmişliğiyle açıklanabilirdi .	NDC
Bir anlık bir etkilenmeyle seçtiği , mutluluk ya	da	mutsuzluk beklemeksizin birlikte olmayı deneyip kolayca terk edeceği biri .	NDC
Hayır , hiç ilgilenmiyorum . Bilimkurgu ya	da	kurmaca bir şey dene , diye öğüt veriyor Erkböke , romantizm öldü artık , ayağa düştü , direnenlerin son temsilcisi benim .	NDC
Yazmak yalnızlıktır , buyuruyor , kendini bağışlamaktır , yavaşça intihar etmektir . Bakıyorum	da	şimdi eline kalemi alan yazarım diye ortaya çıkıveriyor , bu ne bolluk böyle yahu , kolay mı yazmak ?	DC
Ne tiksinti ne özlem . Panik belki ya	da	öylesine bir üşüme sabahın serinliğinden .	NDC
Yok olmanın nedeni gibi , süresi ve seçmeli oluşu	da	çözüm bekleyen sorulardandır .	NDC
Troposferdeki ozon değişimi ; iklim değişikliklerinin nedeni oldu , deniz ve göl ortamlarının üst kesimlerinde yaşayan planktonların yüzde 15-20 oranında azalmasını sağlayarak , besin zincirinin bu ilk halkasında önemli bir kırılmayı	da	gerçekleştirdi .	DC
II . Büyük Toplu Yok olmanın nedeni olarak gösterilen meteorit çarpmasının koşulları , güncel olarak	da	dünyamızı tehdit ediyor .	NDC
Jüpiter için gerçek olan uzay koşullarının , bir gün Dünya için	de	gerçek olabileceği unutulmamalıdır .	NDC
Acaba , bir kısım canlının yok olmasına neden olan faktörler , neden diğerleri için	de	etkin olmamıştır ?	NDC
Toplu Yok olma , var olan türlerin çoğunun ya	da	birkaçının , tek bir stratigrafik horizonda veya çok dar bir stratigrafik arada aniden yok olmasıyla belirlenir .	NDC
... bu etkilerle fauna-flora değişiminin 100 .000 yıl ya	da	daha uzun bir zaman aralığında gerçekleştiğini ileri sürmüştür .	NDC
Bilginin kaynağı toplumsal pratiktir . Büyük bilimsel ve düşünsel devrimlerin kökenine indiğimiz zaman büyük toplumsal pratikleri ve insan ihtiyaçlarını görürüz . Marx bunu , " insanlık kendi önüne , ancak çözüme bağlayabileceği sorunları koyar " diye formüle eder . Bu süreci , bilimsel sosyalist kuramın gelişiminde	de	izleyebiliriz .	DC
( gerçekten de 19 . yüzyılın en köklü devrimci atılımları Fransa , İngiltere ve Almanya gibi en ileri kapitalist ülkelerde yaşanmıştır . Ayrıca Komün ' ün yenilgisinin bir nedeni	de	yaygınlaşamaması , diğer ülkelere , örneğin Almanya ' ya sıçrayamaması olarak tahlil edilir . )	NDC
Rusya , kapitalist gelişme açısından bakarsak , ilerilerin en gerisi , gerilerin en ilerisi idi . Rusya ' da başlayan sosyalizm pratiği , çoğu Bolşeviğin , hatta başlarda Lenin ' in	de	düşündüğü gibi Avrupa ' ya değil , Asya ' ya doğru yayıldı .	NDC
…bir 20 . yüzyıl devrim modeli geliştirilmiş ve bu , bir yüzyıl boyunca kanıtlanmıştır . 20 . yüzyılın sosyalizm modeli	de	19 . yüzyıldan farklıdır .	DC
Sol-Hegelci düşüncenin en radikal temsilcisi ise bir başka ünlü Alman filozofu Ludwig Feuerbach ' tı . Feuerbach ' ın yazıları , içlerinde Marx ' ın	da	bulunduğu demokratik ve tanrı tanımaz fikirlere sempati duyan gençleri büyük ölçüde etkilemişti .	NDC
Böylece kapitalist sömürünün mekanizması ( emeğin meta haline gelmesi ve işçinin emeğinin bir bölümüne kapitalist tarafından el konulması ) açıklanmış , kapitalist zenginliğin ( sermaye ' nin ) ve kâr ' ın temel kaynağı	da	bulunmuştur . Daha birçok çalışmanın yanı sıra Marx'ın anıtsal eseri Kapital'de bu konu son derece ayrıntılı biçimde incelenmiştir. 	DC
Feuerbach ' ın yazıları , içlerinde Marx ' ın da bulunduğu demokratik ve tanrı tanımaz fikirlere sempati duyan gençleri büyük ölçüde etkilemişti . Marx ' ın kendisi	de	o dönem için , " bir gecede hepimiz Feuerbachcı olmuştuk " diye yazmıştır .	DC
Sovyet ve Çin sosyalizm deneyleri yaşanmasaydı , bugün Marx ' ı " parlak bir 19 . yüzyıl filozofu " , Bilimsel Sosyalizmi	de	 bir 19 . yüzyıl düşünce akımı  olarak anacaktık .	NDC
Mao , sosyalizmin uzun sürecek bir geçiş aşaması olduğunu , sınıfların ve sınıf mücadelesinin üretim araçlarının toplumsal mülkiyeti tamamlandıktan sonra da devam edeceğini , bu dönemde geri dönüş tehlikesinin tamamen bertaraf edilmediğini , tehlikenin tasfiye edilen burjuvaziden değil , bizzat sosyalist parti ve devlet aygıtı içinde yer alan mevki sahibi kapitalist yolculardan kaynaklandığını , sosyalizmi kurmanın esas itici gücünün emekçi kitlelerin devrimci inisiyatifi olduğunu , partinin	de	bu inisiyatifin önderi olabildiği sürece sosyalizm yolunda ilerlenebileceğini söylemiştir .	DC
 Deha  yı yaratan işte bu toplumsal gelişmedir ; " kapitalizmin mezar kazıcısı " proletarya ortaya çıkmıştır , Marx	da	onu keşfetmiştir .	DC
Öte yandan özellikle Fransız ütopik sosyalistleri , Saint Simon , Fourier vb . , kapitalizmi eleştirerek sömürüsüz-sınıfsız bir toplum düşüncesine ulaşmışlardı . Marx , yukarıda	da	söz ettiğimiz gibi , bu büyük insanlık ütopyasını hangi toplumsal gücün gerçekleştirebileceğini keşfetmiştir .	NDC
Marx , yukarıda da söz ettiğimiz gibi , bu büyük insanlık ütopyasını hangi toplumsal gücün gerçekleştirebileceğini keşfetmiştir . Bu keşfin esas laboratuarı	da	Paris ’ tir .	DC
Klasik felsefeyi aşıp Diyalektik ve Tarihi Materyalizme ulaşanın , bir köyde inzivaya çekilip felsefe yapan " hoca " Feuerbach değil	de	, dönemin politik eylemlerine doğrudan katılan , Avrupa ' nın bir kentinden diğerine sürülen , Paris ' te barikatlara çıkıp Manchester ' de işçilerle birlikte yaşayan " çömezler " Marx ve Engels olmasının nedeni de bu olsa gerek .	NDC
19 . yüzyıl koşullarında doğru olan ve pratikten çıkarılan bu model ( gerçekten	de	19 . yüzyılın en köklü devrimci atılımları Fransa , İngiltere ve Almanya gibi en ileri kapitalist ülkelerde yaşanmıştır . Ayrıca Komün ' ün yenilgisinin bir nedeni de yaygınlaşamaması , diğer ülkelere , örneğin Almanya ' ya sıçrayamaması olarak tahlil edilir . ) , 20 . yüzyılda kökten değişecektir .	NDC
Marx , Alman sosyal demokratlarını ( o zaman komünistlere , sosyal demokrat deniyordu ) eleştirdiği bu eserinde ; " herkes yaratılan toplumsal değerden verdiği emek oranında pay alacak " biçimindeki sosyalist iktisat ilkesinin , aslında çok eşitlikçi gibi gözükmesine karşın eşitsizliği engelleyemeyeceğini , hatta yeni bazı eşitsizlikler yaratabileceğini , dolayısıyla hâlâ bir burjuva ilke olduğunu , hedefin " herkes verebildiği kadar verecek ve ihtiyacı kadar alacak " ilkesini hayata geçirmek olduğunu , ama bu düzeye	de	ancak " bolluk toplumu " nda , yani sınıfsız toplumda varılabileceği söyler .	NDC
Marx , dünyanın Avrupa ve yakın çevresinden ibaret olduğu bir dönemde , hem	de	yaşlı kıtanın merkezinde yaşadı .	NDC
Bilimsel sosyalist düşüncenin üç kaynağı olduğu söylenir : Alman felsefesi , İngiliz ekonomi politiği ve Fransız sosyolojisi ( ya	da	sosyalizmi ) .	NDC
Marx ve Engels ; Diyalektik Materyalizmi , toplumların yapısını ve tarihini incelerken daha	da	genişlettiler .	NDC
Bu teorik analizde ; modern sosyalist kuramların ulaştığı , " sosyalizm aşamasının uzun olduğu , bu aşamada sınıf mücadelesinin devam ettiği , sosyalizmin kendinden kaynaklanan bazı eşitsizlikleri barındırdığı , dolayısıyla devrimi sürdürmenin zorunlu olduğu " gibi sonuçların çekirdeğini görebiliyoruz . Bu	da	Marx ' ın " deha " sı olsa gerek .	DC
Her odadan diğerine geçiliyor ; ama giriş damdan , evlerden dışarıya çıkamıyorsunuz . Evlerin aralarında çok dar koridorlar , avlular var . Çatalhöyük ' te	de	aynı şekilde evlere damdan giriyorsunuz .	DC
Öteki yapı da tapınakla beraber olan ve yönetimle ilgili bir başka bina . Yani burada oturanlar , öteki konutlarda oturan insanlardan farklı ; işlevleri	de	farklı .	NDC
- " Bu durumda , bakır kullanımının daha önceki tarihlemesiyle ilgili bilgiler altüst oluyor . "      - " Tabii , bilinenden çok daha erken . Bu Anadolu ' da yalnız Aşıklı ' da değil , Çayönü ' nde	de	bulundu . "	NDC
Şimdi bizim arkeometrimiz de dünyadakilerle yarışmaya başladı . Bu	da	çok onur verici . Yabancılardan proje alan arkadaşlarımız var .	DC
Aşıklı'daki insanlar Çatalhöyük'e gittiler ve geldikleri yer, anayurtları Aşıklı olduğu için, onun resmini yaptılar. Böyle bir yorum getiriliyor. Yani şu anda dünyanın en eski planı Aşıklı'ya ait." Çatalhöyük ile Aşıklı arasında kültür olarak	da	birtakım benzerlikler var .	DC
Çatalhöyük ile Aşıklı arasında kültür olarak da birtakım benzerlikler var . Bu benzerliklerin yanında farklılıklar	da	var .	DC
Aşıklı Höyük Kazısı pek çok ilke ev sahipliği yapıyor . Avcı bir toplum , tarım henüz başlamış ; ama son derece gelişmiş bir toplumsal örgütlenme var . İşbölümü ayrıntılanmış ve yönetici sınıf oluşmuş . Dünyanın en eski kent planı , Aşıklı Höyük ' e ait , en eski çevre duvarı	da	orada .	DC
Mesela ilk heykel sanatı , ilk kabartma sanatı Anadolu ' da ; Çatalhöyük ' den de 1500 sene önce Nevalı Çori ' de , Göbeklitepe ' de bulundu . Ayrıca Çayönü var , akıl almaz bir yerleşim yeri . Aşıklı Höyük	de	, bir taraftan Çatalhöyük ' ün öncüsü .	DC
Bütün bunlar yapıldı Türkiye ' de . Ama kurumlaşma daha sonra oldu , amatör ruhla çalışıldı . Şimdi bizim arkeometrimiz	de	dünyadakilerle yarışmaya başladı .	DC
Mesela ilk heykel sanatı , ilk kabartma sanatı Anadolu ' da ; Çatalhöyük ' den	de	1500 sene önce Nevalı Çori ' de , Göbeklitepe ' de bulundu .	NDC
Çatalhöyük ' te bulunan bir duvar resminde , Hasandağı görünüyor ve altta da bir yerleşim resmi var . Şimdiye kadar bu alttaki resmin , Çatalhöyük ' ün planı , üsttekinin	de	Hasandağı olduğu tezi öne sürüldü .	NDC
Yani arkeoloji tek başına yetmiyor . Şimdi klasik kazılarda	da	arkeometri araştırmalarına başlandı .	DC
Bu yapı birimi , tapınak olarak adlandırdığımız bir yer . Öteki yapı	da	tapınakla beraber olan ve yönetimle ilgili bir başka bina .	DC
Bakır Çukuru diye bir yer var ; oraya gittik , araştırmalar yaptık. Arkeometalurglar	da	örnekler topladı .	DC
Bakır kaynakları alınıyor ; doğal bakır yumuşak , onu soğukken	de	sıcakken de dövebilirsiniz .	DC
Bakırın tavlandığı ilk yerleşimlerden . Ölüler belki	de	ilk kez orada kefene sarıldılar ...	NDC
Burada önce kerpiçle başlayan insanlar , sonradan taşı öğreniyor , kullanıyorlar . Birçok şey bakımından , burası başlangıç . O yüzden	de	yok olmaması gerekiyor .	NDC
Bir de olasılıkla 3 . tabakada eski yerleşim yeri var . Bu	da	Melendiz kıyısında , güney tarafta , tamamen höyüğün dışında .	NDC
Öğütme taşları çok büyük , ama öğütme taşlarının bir kısmı hem öğütme işleminde , hem	de	belki taş işçiliğinde kullanılıyor .	NDC
Ayrıca Arkeometalurji çalışmalarında bir atılım yaptık . O	da	şimdi Boğaziçi Üniversitesi ' nde uygulanıyor .	NDC
Neolitik dönem deyince , yalnızca akla Mersin ' deki , Hatay ' daki kazılar geliyordu . Sonra ilk yerleşik köy dönemi olarak	da	, yüzey araştırmalarıyla saptanan höyükler arasında Çayönü seçildi .	NDC
Ahmet Mithat ' ın romanlarında sağlam bir İslâmî terbiye çoklukla babasızlığı telâfi eder ; karşıtlık , Avrupalılaşmak uğruna kafası karışmış babalarla bu kültür arasındadır . Böyle bir yapı , babasızlığa bulunmuş oldukça pratik , sağduyulu bir çözümdür ve Ahmet Mithat ' ı babasızlık tehdidini trajik gören diğer Tanzimat yazarlarından ayırır . Abdülhamid ' i kolaylıkla benimsemesi	de	her şeyde olduğu gibi ,  baba arayışında da Ahmet Mithat ' ın en pratik çözümlere yönelebildiğinin başka bir göstergesi sayılmalıdır .	DC
Abdülhamid ' i kolaylıkla benimsemesi de her şeyde olduğu gibi , baba arayışında	da	Ahmet Mithat ' ın en pratik çözümlere yönelebildiğinin başka bir göstergesi sayılmalıdır .	NDC
Ahmet Mithat ' a göre İslâm kültürünün büyük üstünlüğü manevî değerlere verdiği önemle namuslu ve iffetli insanlar yetiştirmesindedir . Bu konuda Namık Kemal	de	aynı onun gibi düşünür .	DC
Dahası Ceylan gibi o da " yanlış şeyler okuyarak " yolunu , hatta Ceylan ' dan biraz farklı olarak , aklını	da	yitirmiş bir gençtir .	NDC
Ahmet Mithat ' a göre İslâm kültürünün büyük üstünlüğü manevî değerlere verdiği önemle namuslu ve iffetli insanlar yetiştirmesindedir . Bu konuda Namık Kemal de aynı onun gibi düşünür . Aile bağı gibi bazı bağların Batı ' daki gibi zayıflamamış olması	da	İslâmî kültürün camiacı niteliğinden ileri gelir ve bu camiacılık korunması gerekli bir niteliktir .	DC
Bunlara Avrupalı demek caiz olabilecekse de sözün doğrusunu söyleyelim ki terakkiyât-ı fikriyenin o derecesi Avrupa ' da mehâsin-i ahlâk gayretinde bulunanlar nezdinde	de	istihsan edilememektedir .	NDC
Bunlara Avrupalı demek caiz olabilecekse de sözün doğrusunu söyleyelim ki terakkiyât-ı fikriyenin o derecesi Avrupa'da mehâsin-i ahlâk gayretinde bulunanlar nezdinde de istihsan edilememektedir. Recaizade Ekrem ' in Araba Sevdası ' nda Bihruz Bey ' in traji-komik öyküsü	de	, gerçekte , babanın yokluğundan öte , metinsel rehberini kaybetmiş ve yanlış metinler arasında kaybolmuş bir gencin , yani cehaletin öyküsüdür .	DC
Dolayısıyla , Hıfzı Veldet ' e göre Mecelle fıkha , yani İslâm kanununa dayanır ve " dine müstenit hukukun muğlaklığını taşır . Namık Kemal	de	24 sayılı İbret ' te çıkan bir makalesinde Tanzimat ' ın getirdiği yeni hukuksal düzenlemeleri eleştirirken şöyle der :…	DC
Zavallı Bihruz Bey ' in , M . Piyer ' in sorumsuz , plansız , programsız ve yalnızca alacağı parayı gözleyen eğitimine karşı kendisini koruyacak ya da yönlendirecek bir rehberi , yani bir babası ya da klasik eğitimi yoktur . Tanzimatçılar , adetleri bir miktar çoğalmış olan sıbyan mekteplerini	de	medresenin nüfuzundan kurtaramamışlar ve bu mektepleri , dünyevî gayelere hizmet eden ve çocuklara laakal kendi anadillerini okuyup yazmayı öğreten basit bir ilkmektep haline koyamamışlardır .	NDC
Ceylan nasıl okuduğu Batı romanlarıyla bir " feminist " olup çıkmışsa , Bihruz Bey	de	okuduğu gayet seviyesiz aşk şiirleriyle komik bir " aşık " olup çıkar .	DC
O müslümandır ve 18 ' inci asır feylesoflarının fikrî hareketinin getirdiği şeyleri , İslâm dininde , şeriatte ve fıkıhta arayacak kadar müslümandır . Ziya Bey	de	bu hususta kendisinden ayrılmaz .	DC
Orhan Okay bize Ahmet Mithat ' ın Bağdatlı Muhammed Zilhavi ' den medrese bilimlerini , Muhammed Şirazlı Bakır Can Muattar ' dan	da	Doğu ilim ve felsefesini öğrendiğini söyler .	NDC
Bu yazarların " yenilikçilik " lerinin onları bir Doğu-Batı ikilemine ittiği kanımca bir Cumhuriyet ideolojisi yorumudur . Bu yorum	da	ya yakın tarihimize bir kültürel ikilem yakıştırarak bu ikilemin Cumhuriyet ' le en " hayırlı " biçimde çözüldüğü yanılsamasından , ya da Cumhuriyetçiler ' in kendi ikilemlerini önceki kuşaklara yansıtmalarından kaynaklanıyor olabilir .	DC
Tanzimat döneminde egemen metin dediğim bu İslâmî düşünce ve dünya görüşünün çizdiği sınırlar içinde kabul edilmiştir . Bu sınırlar	da	pek öyle cömertçe çizilmemişti .	DC
Şeriat ahkâmı herkesin hukukunu	da	vazifelerini de ; akla , hikmete ve keyfiyete gayet uygun şekilde ayarlamıştır .	NDC
Rakım Efendi ' nin eğitiminde öncelikle İslâmî ilim ve sanatların geldiğini , ancak bunlardan sonra kimya , fizik , anatomi gibi müsbet ilimlere	de	yer verilebileceğini ; Rakım Efendi ' nin eğitiminin de , dünya görüşünün de temelini İslâmî ilimlerin oluşturarak müsbet ilimlerin sınırlarını belirlediğini görüyoruz .	NDC
Rakım Efendi ' nin eğitiminde öncelikle İslâmî ilim ve sanatların geldiğini , ancak bunlardan sonra kimya , fizik , anatomi gibi müsbet ilimlere de yer verilebileceğini ; Rakım Efendi ' nin eğitiminin	de	, dünya görüşünün de temelini İslâmî ilimlerin oluşturarak müsbet ilimlerin sınırlarını belirlediğini görüyoruz .	NDC
Babanın yokluğunda tek tutamak kuvvetli bir ahlâk anlayışı gibi görünüyordu . Belki	de	bu yüzden ondokuzuncu yüzyılda çok sayıda " oğula nasihat " ya da " çocuk terbiyesi " kitaplarına rastlarız .	NDC
Romanlarında bıkmadan usanmadan , babanın yokluğunda doğru ahlâk ve terbiyeye ulaşabilmiş çocukların kurtulabildiğini , diğerlerinin ise baştan çıkarak kaybolduklarını anlatır . Ahmet Mithat Efendi ' de " mürebbi-i efkâr " ın ille	de	bir baba olarak şahıslanması gerekmiyordu .	NDC
Ahmet Mithat Efendi ' de babasızlık , yanlış terbiyeyle eşittir . Kendisi	de	sağlam bir Osmanlı eğitimi görmüş olan Ahmet Mithat Efendi için tek çıkış İslâmî bir terbiye ve kültürün yol göstericiliğinde ilerlemedir .	DC
Ahmet Mithat Niza-ı İlm ü Din ' de şöyle der : " Medeniyet ve insâniyet ve diyanet nokta-i nazarlarından hiçbir kıymeti olmadıktan fazla , değersizliği , kıymetsizliği bedihî ve aşikâr olan bazı aksâm-ı edebiye bir takım genç mütercimler tarafından tercüme veyahut taklit yollu lisanımıza geçirilmekte ise	de	beri tarafta hikmet-i vâsia ve sâfiye-i islâmiye zaten ahlâk-ı umumiyemizi öyle bir metanetle takviye eylemiştir ki o edebiyat-ı meşkûkenin milyonda bir müslümanı cidden tağlit edebileceğine ihtimal verilemez . " 18 Ahmet Mithat ' ın romanlarında sağlam bir İslâmî terbiye çoklukla babasızlığı telâfi eder ; karşıtlık , Avrupalılaşmak uğruna kafası karışmış babalarla bu kültür arasındadır .	DC
Allah bizim belâmızı o mel ' un alafranga yüzünden vermek için çeşm-i basiretimizi bağlamış	da	 kızım orada alafranga terbiye alıyor  diye beni sevindirmiş .	DC
Allah bizim belâmızı o mel ' un alafranga yüzünden vermek için çeşm-i basiretimizi bağlamış da " kızım orada alafranga terbiye alıyor " diye beni sevindirmiş . Şimdi	de	işte böyle kan ağlatıyor .	NDC
Şimdi de işte böyle kan ağlatıyor . Şimdi	de	Felatun Bey ile Rakım Efendi ' de Rakım Efendi ' nin doğru yoldan sapmamasını sağlayan , yaşamının her dönemecinde ona rehberlik eden mutlak metnin Ahmet Mithat Efendi ' ye göre nelerden oluştuğuna bir bakalım .	NDC
Batıcı bir eğitimin ancak ve ancak böyle mutlak bir metin ya da mutlak İslâmî ilimler gölgesinde ve denetiminde edinildiğinde zararsız kalabileceği , mutlak bir metne eklenebileceği , bu haliyle	de	bir gencin eğitiminin ikincil bir parçası olabileceği söyleniyor .	DC
Burada dikkat edilecek şey , " garbiye " için tutulan " madama " nın olası , belki	de	kaçınılmaz kötü etkilerinden çocukları korumak olmalıdır .	NDC
Bunu pek iyi anlamanızı arzu ederiz . O yeni fikirlerin en aşağı dereceleri o kadar müdhiştir ki o derecelere varanlara " müslüman " demek , yalnız " müslümanım " diye ikrarlarından dolayı mümkün olabilip tasdikleri araştırılacak olursa hiç	de	mümkün olamayacağı görülür .	NDC
Çünkü böyle ahvalde kadınlara karşı endiferans göstermekten başka müessir ve müfit bir tedbir olamayacağı kâide-i tecrübiyesini o romanların kendisine bahşettiği fevâit cümlesinden olmak üzere tahattur ederek olduğu gibi orada kalmaya ve ( lando ) tekrar gelip geçtiği vakit kendisi	de	vazifesizce başka bir tarafa bakmaya karar verdi .	NDC
Giderek , gerçekle yanılsama arasındaki çizgiyi sözcüklerde yitiren Bihruz Bey ( ss . 75-77 ) sonunda ünlü " siyehçerde " yorumuyla belki	de	dünya edebiyatının en eşsiz budalaları arasında yerini alır .	NDC
Rakım Efendi gibi idealize ederek özdeşleştiği bu roman başkişileri , aklı başında annelerin tuttuğu İslâm düşünce ve terbiyesine vâkıf eğitmenlerle yetiştirilmiş çocuklardır . Yozlaşmış babaların varlığı , babasızlıktan daha	da	büyük bir tehlike oluşturabilir : Ahmet Metin ve Şirzat ' ta Neofari ' nin babası , Felatun Bey ile Rakım Efendi ' de Felatun Bey ' in babası , Jön Türk ' te Ceylan ' ın babası gibi .	NDC
Ceylan ' ın babasının pişmanlık dolu feryatlarında ise , oğluna sahip çıkamamış bir kültürün dövünmelerini duyup , bir yandan ders alıp , bir yandan	da	arınmamız gerekir .	NDC
Örneğin Felsefe-i Zenan ' da Fazıla Hanım ' ın eğitimi böyle bir eğitimdir . Bu tür bir eğitimden geçmiş çocuklar babanın ölümünden sonra	da	yollarını şaşırmazlar .	NDC
İyi yetişmenin bir tek koşulu vardır : o	da	Jön Türk ' ün Ahdiyesi ' nin yaptığı gibi İslâm kültürünün Batı kültürüne üstünlüğünü bir an bile gözardı etmemek .	DC
 Siyehçerde  komedisi bu şaşkınlıktan kaynaklanıyor çünkü Bihruz Bey anadilinde sözlük kullanmasını bile bilmiyor . Dahası Ceylan gibi o	da	 yanlış şeyler okuyarak  yolunu , hatta Ceylan ' dan biraz farklı olarak , aklını da yitirmiş bir gençtir .	NDC
Ahmet Mithat ' a göre Müslüman kadının bu camiacı toplumda öylesine ayrıcalıklı bir konumu vardır ki feminizme hiç gerek yoktur . Bir kez Katoliklik ' te boşanma yoktur fakat Müslümanlıkta vardır ; bu	da	kadına kötü bir evliliğe mahkum olmama şansı verdiği için iyidir .	DC
Belki de bu yüzden ondokuzuncu yüzyılda çok sayıda " oğula nasihat " ya	da	 çocuk terbiyesi  kitaplarına rastlarız .	NDC
Batıcı bir eğitimin ancak ve ancak böyle mutlak bir metin ya	da	mutlak İslâmî ilimler gölgesinde ve denetiminde edinildiğinde zararsız kalabileceği , mutlak bir metne eklenebileceği , bu haliyle de bir gencin eğitiminin ikincil bir parçası olabileceği söyleniyor .	NDC
Zavallı Bihruz Bey ' in , M . Piyer ' in sorumsuz , plansız , programsız ve yalnızca alacağı parayı gözleyen eğitimine karşı kendisini koruyacak ya da yönlendirecek bir rehberi , yani bir babası ya	da	klasik eğitimi yoktur .	NDC
Ceylan nasıl okuduğu Batı romanlarıyla bir feminist olup çıkmışsa Bihruz Bey de okuduğu gayet seviyesiz aşk şiirleriyle komik bir aşık olup çıkar . Kişiliğini gerçekler ya	da	yaşantısı değil sözcükler belirler .	NDC
Bu yorum da ya yakın tarihimize bir kültürel ikilem yakıştırarak bu ikilemin Cumhuriyet'le en "hayırlı" biçimde çözüldüğü yanılsamasından , ya	da	Cumhuriyetçiler ' in kendi ikilemlerini önceki kuşaklara yansıtmalarından kaynaklanıyor olabilir .	NDC
Hiç değilse Tanzimat düşünce ve edebiyatına egemen olan özellik ikilem değil, tersine İslâm düşünce, felsefe, dünya görüşü ve bilgi kuramının tartışılmaz belirleyiciliğidir. Bütün yenileşme ya	da	batılılaşma hareketleri , Tanzimat döneminde egemen metin dediğim bu İslâmî düşünce ve dünya görüşünün çizdiği sınırlar içinde kabul edilmiştir .	NDC
Recaizade Ekrem , Araba Sevdası ' nda kendi yazdığını sürekli hiçlerken çağının ve edebî geleneğin diğer metinlerine de sürekli göndermeler yapar ; bu metinlerarası göndermelerden klasik Divan Edebiyatı , çağdaşı Tanzimat Edebiyatı ve Fransız romantikleri paylarını alırlar . Yalnız bütün bu göndermeler içinde , roman kendi kendini	de	hiçler ; bir bakıma kendine de gönderme yaparak , yazılış mantığını sorgular .	NDC
Recaizade Ekrem , Araba Sevdası ' nda kendi yazdığını sürekli hiçlerken çağının ve edebî geleneğin diğer metinlerine de sürekli göndermeler yapar ; bu metinlerarası göndermelerden klasik Divan Edebiyatı , çağdaşı Tanzimat Edebiyatı ve Fransız romantikleri paylarını alırlar . Yalnız bütün bu göndermeler içinde , roman kendi kendini de hiçler ; bir bakıma kendine	de	gönderme yaparak , yazılış mantığını sorgular .	DC
Bihruz Bey ilk bakışta Ahmet Mithat Efendi ' nin alafranga züppelerini , o tahsilsiz , terbiyesiz Felatun Bey ' lerden birini çağrıştırır . O	da	genç yaşta babasız kalmıştır .	NDC
Onlar bitince İstanbul tarafındaki en az irat getiren dükkânlar birer birer defolundu . Badehu Beyoğlu ' ndaki ehemmiyetli mağazalara sıra geldi . Bunlar	da	elden çıkarıldı . İrat namına Galata ' da bir han kalmış idi .	DC
Çamlıca bahçesinde Periveş Hanımı ilk gördüğünde dinlemekte olduğu Belle Heléne opereti roman boyunca Bihruz Beyin zihnindedir sevindikçe bu melodiyi mırıldandığını duyarız üzüldükçe kâbuslarının müziği olur . Recaizade Ekram'in sık sık başvurduğu başka bir dil parodisi	de	, edebî gelenekte daha önce ciddi ve soylu konuların anlatımında benimsenen bir üslûbu , Bihruz Bey ' in sıradan , komik , anlamsız davranışlarını betimlerken kullanmasıdır .	NDC
İkincisi , müdahaleci , her şeyi bilen , mutlak anlatıcı konumunu koruyan Recaizade Ekrem ' in	de	anlatımında benimsediği bir dil yoktur .	NDC
Kimi zaman eski metinlerdeki klasik üslûbu kullanır ; yer yer kişilerin ( özellikle	de	Bihruz ' un ) konuşma ve düşünme üslûbunu taklit eder .	NDC
Mutlak bir anlatı üslûbunu benimsememesi , onun mutlak anlatıcı işlevini de kısıtlar : bu bakımdan babasızlığın anlamını anlatıda	da	hissettirebilmiş tek Tanzimat yazarıdır .	NDC
Derken Bihruz Beyin yağız atı beyin altından sıyrılıp ve büyük bir atmaca gibi havalanıp uçmaya , kaplumbağalar dansetmeye , fino köpeği	de	( Belle Helene ) operasından bir parçayı terennüm ederek havlamaya başlıyor .	DC
Filhakika o pirâneser ağaçlar vaktiyle genç idi , havay-ı arzu önünde bîkarar olan ehl-i şebap gibi bunlar	da	en hafif bir rüzgâr ile hemen ihtizaza gelirler ve şevk ve ümide dair güft-ü şinide başlarlar idi .	NDC
Dahası , romanda kullanılan diller kimseye ait değildir ; kimse ne kendi kullandığı dili , ne de başkalarının kullandığı dili anlar . Bu iletişimsizlikte açıklamalar , yinelemeler	de	yarar sağlamaz .	DC
Bu yaklaşım genelde hazır biçim ve izlekleri kırıp değişmeye zorlayarak , ya eski biçimlerin parodisi ya da yeni biçim denemeleriyle eskiye başkaldırıyı da içerir . Recaizade Ekrem , Araba Sevdası ' nda kendi yazdığını sürekli hiçlerken çağının ve edebî geleneğin diğer metinlerine	de	sürekli göndermeler yapar .	NDC
Recaizade Ekrem haşarı bir oğuldur . Eğer Tanzimat romanına bir batılılaşma romanı değil	de	bir modernleşme romanı olarak bakarsak , Araba Sevdası gerçek anlamda modern ilk romandır .	NDC
Bu aralık Mösyö Piyer etekleri yerlere sürünür derecede uzun bir rop dö şambr giymiş , başında rengâmiz tüylerle müzeyyen bir kadın şapkası , iki koltuğunda	da	birer bordo şişesi olduğu halde birdenbire meydana çıkıyor	NDC
Recaizade Ekram ' in sık sık başvurduğu başka bir dil parodisi de , edebî gelenekte daha önce ciddi ve soylu konuların anlatımında benimsenen bir üslûbu , Bihruz Bey ' in sıradan , komik , anlamsız davranışlarını betimlerken kullanmasıdır . Bu tür parodi , olay ya	da	, kişinin bu yüksek dili haketmediğini karşıtlık yoluyla göstererek ,	NDC
Bu tür parodi , olay ya da , kişinin bu yüksek dili haketmediğini karşıtlık yoluyla göstererek , olayın ya	da	kişinin komikliğini vurgular .	NDC
Araba Sevdası ' nda arabalar yokolur , sevdalar yiter , sevgili kayıplara karışır , metinler buruşturulmuş kağıtlar üzerinde boşluğa atılır , ilişkiler ( özellikle	de	Bihruz ' un annesiyle ve hocasıyla ilişkisi ) çıkar ilişkilerine dönüşür , eylemler , Çamlıca ' daki arabaların döne döne gidişini yineleyen " muttasıl ve müselsel devreden zencir-i müteharrik " gibi1 hiçbir yere ulaşamayan , bir kısır döngüyü , sanki aynı abes merkeze zincirlenmişcesine tekrarlayan eylemlerdir .	NDC
Yanılsama ile gerçeklik arasındaki mesafenin aşılması için gerekli yazın yöntemi ya	da	yöntemlerinin Tanzimat döneminde yapılmış ilk roman denemelerinden çıkamayacağı inancındadır ; bu karamsarlığını Araba Sevdası ' nı baştan sona bir yazma ve okuma eylemi parodisi biçiminde kurgulayarak dile getirir .	NDC
Bu yaklaşım genelde hazır biçim ve izlekleri kırıp değişmeye zorlayarak , ya eski biçimlerin parodisi ya	da	yeni biçim denemeleriyle eskiye başkaldırıyı da içerir .	NDC
Bu yaklaşım genelde hazır biçim ve izlekleri kırıp değişmeye zorlayarak , ya eski biçimlerin parodisi ya da yeni biçim denemeleriyle eskiye başkaldırıyı	da	içerir .	NDC
Onların , benim için , hayatları dahil feda etmeyecekleri hiçbir şey olamazdı . Bunu her türlü yoksulluğun yaşandığı acılı günlerde	de	zenginlik ve mutluluk yaşanırken de görüyordum .	NDC
Ülkenin yoksulluk içinde bulunduğu , ekmeğin karneye bağlı olduğu savaş yılları içinde onların bu cömertlikleri ayrıca bir önem kazanıyordu . Gerçekten	de	babanın eli açıktı .	NDC
Ben bunu babamın bencilliği olarak görüyordum . Aynı hareketi Ortaköy ' de	de	yaptı seneler sonra .	DC
Ben yanlarına gitmiyorum , biraz önce babanı dışarı çağırdım , artık gitsinler dedim . O	da	bana bir tokat attı,	DC
 Cehennem ol git , " dedi . Bana tokat atarken kapı aralıktı, içerideki kadınlar	da	gördüler . "	DC
Ben annemi öptüm teselli ettim , hemen yukarı çıktım . Çıkarken anam , arkamdan " Sen	de	gitme oğlum , köpek sana da bağırır belki , "  diye sesleniyordu .	NDC
Ben annemi öptüm teselli ettim , hemen yukarı çıktım . Çıkarken anam , arkamdan " Sen de gitme oğlum köpek sana	da	bağırır belki , "  diye sesleniyordu .	NDC
Babamın " Oğlum oturup yesene , " dediği anda , ben onun o anki yaşamı için ve anneme yaptıklarının etkisinde	de	kalarak yüksek sesle " İğrenç bunlar , " dedim .	NDC
Elli kadar öğrencisi bulunan 4 H sınıfından on beş öğrenci geçmişti 5 E ' ye ; bunların arasında Kemal	de	vardı . Kendisi bile inanamıyordu sınıfı geçişine , o yılla ilgili hemen hemen hiçbir şey hatırlamıyordu . Ne öğretmen , ne öğrenci ; ne de okunan dersler .	NDC
Kendisi bile inanamıyordu sınıfı geçişine , o yılla ilgili hemen hemen hiçbir şey hatırlamıyordu . Ne öğretmen , ne öğrenci ; ne	de	okunan dersler . Babası , oğlunun böyle bir arkadaşı olduğu için çok sevindi . " Eğitim gören , ciddi arkadaşları olmalı insanın , " dedi . Bu düşünceye annesi de katıldı .	NDC
Babası , oğlunun böyle bir arkadaşı olduğu için çok sevindi . " Eğitim gören , ciddi arkadaşları olmalı insanın , " dedi . Bu düşünceye annesi	de	katıldı . Hemen evinin yanındaki bu arkadaşıyla , çoktan bir arada yaşar olması , dostluklar kurması gerektiğine kendi de inanıyordu .	DC
Tatil günleri kitap okuyan ve bunu sürdüren bu gence karşı Kemal'in ilgisi gittikçe artıyordu. Bazı akşamlar baba, oğluna soruyordu: "Nasıl, arkadaşını görüyor musun, konuşuyor musun?" diye. Kemal, ancak savuşturarak, bazı yanıtlar veriyordu babasına. Hemen evinin yanındaki bu arkadaşıyla , çoktan bir arada yaşar olması , dostluklar kurması gerektiğine kendi	de	inanıyordu .	DC
Hayatında hiç tiyatroya gitmemişti . Biz ise sonradan yanan Tepebaşı ' ndaki Dram tiyatrosuna ve yanındaki Darülbedayi Komedi Tiyatrosuna bir iki kez ailece gitmiştik . Nimet biraz	da	yılışarak " Hadi anne , hadi anne gidelim , " deyince ve annemden de destek gelince , Ulviye Teyze " Ne oynayi , gülecek miyuz ? " diye sordu bana .	NDC
Kitap sevgisi , kitaplarla insanların dünyasının derinliğine inmek , onları okuduktan sonra bile tüm canlılığı ile yüreğinde taşımak , , insanı öteki insanlar arasında sadece farklı yapıyordu . Bu farkı , ancak kendi	de	farklı olanlar görebilirlerdi .	NDC
Nail , Kemal ' e sadece kitapların isimlerini , yazarlarının önemini söylemekle yetinmiyordu ; bazen içeriğini	de	özetliyordu .	DC
Nail , Kemal ' e sadece kitapların isimlerini , yazarlarının önemini söylemekle yetinmiyordu ; bazen içeriğini de özetliyor ; aynı yazarın başka eserlerinden	de	söz ediyordu . Babanın yaşamı artık derli toplu olmuştu .	DC
Babanın yaşamı artık derli toplu olmuştu . Evde kavgalar	da	azalmıştı .	DC
Mahallede bazı komşular birbirine " Arabın evine kim taşınmış , biliyor musunuz ? " diye soruyor . -Arap dedikleri	de	, babası sarayda ibrikçi başılık yapmış olan Zenci bir kadındı- .	DC
Erkek çocuk saçını ayırmaz , tarak	da	taşımaz , yani süs yapmaz . Onun süsü dürüstlük , mertlik olmalıdır . "	DC
En yakın silah arkadaşı İsmet İnönü Devlet Başkanı olmuştu . Onun adı	da	 Milli Şef  olmuştu .	DC
Tabii karşısında , bu hareketin bir de düşmanı olmalıydı . O	da	hazırdı .	DC
Çocukluğumdan beri her yıl benim , uzun süren günlerini mutlulukla yaşadığım yaz tatilinin üç ayı , haziran , temmuz , ağustos ayları tüm güzelliğiyle o yıl	da	öylesine uzun sürmüştü ki…	NDC
Kitap sevgisi , kitaplarla insanların dünyasının derinliğine inmek , onları okuduktan sonra bile tüm canlılığı ile yüreğinde taşımak , , insanı öteki insanlar arasında sadece farklı yapıyordu . Bu farkı , ancak kendi de farklı olanlar görebilirlerdi . Böylece iyi ve güzel yetişme , aynı zamanda genellikle yalnız kalmayı	da	beraber getiriyordu .	NDC
Kemal ' in kaydını yaptıran polis dayısı ona üzerinde " 4 H 332 Kemal Demirel " yazılı bir kağıdı verirken sarıldı , öptü , başarılar diledi . Okulun açılış gününü söyledi . Fransızca okuyacağını	da	ilave ederek okulun hemen yanındaki karakola vazifesine döndü .	DC
Bir masanın üzerinde bakır tepsisiyle alınmış , sağından solundan yenilmiş baklava ve börek gördüm . Utancımdan ne babamın yüzüne ne	de	odadaki kadınların yüzüne bakamıyordum .	NDC
Kız olsun , erkek olsun ki kız arkadaşım hemen hemen hiç olmadı , biriyle tanışıp merhaba demek hakkım doğunca , benim için son önemli şey hallolmuş , demekti . Çok alıngan , doğal olarak	da	utanan bir insandım .	NDC
Kemal ' e baktı , sonra " Bu dünyada ne güzel , insanlar var değil mi ? " Kemal soruyu fırsat bilmişti , " Senin ne güzel kitapların varmış , hepsi	de	sahiden yaşanmış gibi .	NDC
Daha sonraki yıllarda gördüm ki genelde insanları yönlendiren ne kadar yazık ki çıkarları oluyordu . Büyük ya	da	küçük çıkarlar uğruna insan onuruna yakışmayan davranışlarda bulunuyorlardı .	NDC
Ertesi günün sabahı , Nail ' i sokakta ekmek almaya giderken gördüm . O , bana : " Dün sizin evden neşeli sesler geliyordu , " deyince , bu fırsatı çok güzel kullandım , hemen ona " Onlar Kasımpaşa ' dan ahbaplarımızdı , öğleden sonra	da	çarşıdaki tiyatroya gittik , " dedim .	DC
Misafirler gittikten sonra her akşam evde annemle babam arasında bir ağız kavgası oluyordu . Babamın savunması	da	; " Ne büyütüyorsun bunları , biraz eğlendikse , " oluyordu , " Beyoğlu ' na gitsem , barlarda , meyhanelerde eğlensem , kumar oynasam daha mı iyi , " diyordu .	DC
Ben çıktım , ama onun ne yapmak istediğini anlayamamıştım . Hemen orada bulunan çocuklardan biri " Nihayet Ateş seni	de	dövdü değil mi Kemal ? " dedi .	NDC
Nurhan " Tabii Sabahat , akademinin sorusu gaflet içinde sorulmuş bir soru . " Sabahat düşünceli bir şekilde " Onların insanı nasıl gördükleri	de	ortaya çıkıyor bu soruda . Tekniğin ilerlemesi , insanlığa , insanın bağımsızlığına ve özgür dünyasının gelişmesine doğrudan hiçbir katkıda bulunamaz . Pek çok şeyi , yaşamı kolaylaştırabilir , ama teknik insanlık üretemez ; onu ancak insan üretebilir ...  "	NDC
Yakınım olan üç dört arkadaşımla gerektiği zamanlarda konuşuyor , tartışıyorduk tüm bunları . Ülke bizim ülkemizdi ; tabii ki onun sorunları	da	bizim sorunlarımız .	DC
Elli yıl geçmiş olmasına karşın  hiçbir parti  gençlik dernekleri  cemiyetler ve benzeri toplulukların içinde olmadım . Bunları iyi veya kötünün ötesinde  bir yargı yapmaksızın anlatmak istiyorum . Hürriyetin gelmesi  kısa bir zamanda okulda	da	etkisini gösterdi .	NDC
Ben onlara " Artık kart usulü kalktı , " dedim . Sonra müdüre gittim . Hayatımın en güzel yalanlarından birini söyledim . " Efendim , biz dün Muzaffer Beyle konuştuk , bu kart usulüne artık gerek yok dedi , " dedim . Müdür şaşırarak " Bu nereden çıktı ? " dedi . Ben " Efendim , Demokrat Parti kuruldu ya , artık memleketimizde hürriyet var . Bunlar faşist usulü uygulamalar , hem başka okullarda	da	yok , " diye yanıt verince , suratından hiçbir şey anlamadığı belli olan müdürümüz Şerif Par ayağa kalktı .	NDC
 Tamam , tamam Kemal . Bu öğleyin söylerim çocuklara ,  dedi . Çok memnun olmuştum . Ben çıkarken " Sağ olun Müdür Bey , ben	de	zaten bendeki iki yüz kartı atmıştım , " dedim .	NDC
Sonra bir şeyler söylemiş olmak için " Ben o kızın babasını tanıyorum ; bir şeye dokundu mu , elini hemen yıkayan bir adam , elleri bembeyaz , " diyerek rahatlatmaya çalıştı Kemal ' i ve sonra onun sevineceğini bildiği bir haber verdi . Sabahat	da	var evde , Orhan söyledi bana .	NDC
Ve açılan çift kanatlı saç kapıdan boşalan çocuklar , Küçükparmakkapı Sokağına döküldüler . Eminim ki müdür	de	o anda kendisini hürriyet kahramanı sanmıştı .	DC
Eminim ki müdür de o anda kendisini hürriyet kahramanı sanmıştı . Sormadı , soruşturmadı	da	, çünkü müdür çok memnundu uygulamadan .	DC
O genellikle , koridorda bir pencere içinde teneffüslerde kahve içerdi . Nurhan ' la ben	de	arada bir onu orada görüp yanına giderdik .	DC
Sonradan öğrendik , meğer o öğretmenler odasına girmek istemezmiş	de	onun için koridorda pencere içinde dinlenirmiş .	DC
Bu ispiyoncu çocuk , benim bunları bilişimi ve anlatışımdaki dili beğenmiş olacak ki giderken " Kendine dikkat et Kemal , Muzaffer Bey seni ne yapıp edip dövmek istiyor , " dedi . Ben	de	ona , " Uyarın için teşekkür ederim , sen merak etme , beni dövecek adam daha anasından doğmadı , " dedim .	DC
O şaşkın ya da sinirlenmiş gibi elini diğer eline ses çıkaracak şekilde vurarak " Vay , sen nasıl böyle söylersin ? " dedi . Ben	de	ona , " Kendisine güvenen herkes söyler ; siz de söyleyin , " dedim .	DC
Ben çok saygılı bir duruşta ellerim kenarlara sarkmış , yapay bir şekilde	de	başımı dik tutmuş , onun suratına bakarak bekliyordum .	DC
Muzaffer Ateş ' le aramızda bu nedenle , beni çağırttığı gün şöyle bir konuşma geçmişti . Niye kartını vermiyorsun	da	, hava yapar gibi kâğıda adını yazıp veriyorsun ?	DC
Efendim , ben bir kere hava yapmam ; hava yapanların her türlüsünden	de	iğrenirim.”	DC
Pontus Platüs  Sen kendine Tanrının oğlu diyormuşsun , Yehudiya ' nın kralıyım diyormuşsun . Mucizeler yapıyor , kurtarıcı olduğunu söylüyormuşsun , " deyince İsa	da	 Onu sen öyle söylüyorsun ,  diye yanıt verir .	NDC
Nurhan , kitap elinde uzun uzun anlatıyordu ve hayranlıkla yapıyordu yorumlarını . Bu eser , Jean Jacques Rousseau ' nun " İlimler ve Sanatlar Hakkında Nutuk " isimli kitabıydı . O gün öğleden sonra Orhan , Kemal ' i	de	getirmesini söyleyerek evlerine çağırmıştı onları .	NDC
Bizim için bu olay , içinde bulunduğumuz eğitim kurumunda yaşanılması dayanılmaz bir durumdu .  Öğretmenimiz Talat Erben ' le öğrenci öğretmen gibi değil	de	arkadaş , dost gibi yaşamaya başlamıştık .	NDC
Akşam evde annem bana , önceki akşam bir nebze ucundan anlattığım olayla ilgili olarak , " Ne yaptın o ceplerini dolduran arkadaşlarının resimli kartlarını ? " diye sordu . Ben	de	 Onları çöp kutusuna attım   , diye yanıt verince , " Aaa , niye yaptın oğlum ? "	DC
Ben hemen düzelttim . " Anasının karnından demedim hocam , anasının A ...  ...  .dan " diye düzelttim bağırarak . O şaşkın ya	da	sinirlenmiş gibi elini diğer eline ses çıkaracak şekilde vurarak " Vay , sen nasıl böyle söylersin ? " dedi .	NDC
Araba tekerleği yokken dünyada insanlar vardı . Onların bağımsız dünyası , sevgi dünyası , otomobil ya	da	uçak yok diye bizimkinden daha mı kısıtlıydı yani ?	NDC
Tülden elbiseler giyinmiş küçük balerinler , elindeki sopayı yanlış yapanların bacaklarına indiren Madam Arzumanova adlı Rus hocalarının idaresinde gözlerimizin önünden çabuk çabuk , uçuşarak geçtiler . " Sopanın acısını bacaklarında en çok hisseden çocuk bendim . Baleye karşı	da	bir yeteneğimin olmadığı kısa sürede ortaya çıktı .	DC
Turizm ve Tanıtma Bakanlığının memur almak için bir sınav açtığını gazetede okumuştum . Başvurdum ve yüzlerce adayla birlikte sınava girdim . İki kişi kazandı . Bunlardan biri	de	bendim ve mütercim radyo dinleyicisi kadrosuyla işe alındım .	NDC
Fakat bürokrasiyi hiç bilmiyordum . Yaşamımdaki pek çok şey gibi , memuriyet hayatına	da	fazla düşünmeksizin dolu dizgin atıldım .	NDC
Büyük bir sarsıntı geçirmişse de , toparlanması fazla uzun sürmemiş . Moda Parkında buluşacakları bir gün , Meltem ' i	de	arayarak oraya çağırmış .	NDC
 Yaşadıklarımı , özellikle beni çok etkileyen olayları asla unutmam ,  dedi . " Geçmişi böylesine taze tutabilmemde kasetlerin	de	yardımı oluyor elbette . "	NDC
 Kasetler mi ?   " Evet , kitaplıkta gördüğün video kasetlerinde yaşamımdan kesitler var . Kimin çektiğini ben	de	bilmiyorum .	NDC
Kasımpaşa ' nın , aynı sınıfta okuya okuya başı dönmüş , sakalı bıyığı çıkmış , sigara içen , kumar oynayan , yaşı benden çok büyük esnaf çocuklarıyla doluydu . Recep Gökgöz	de	onlardan biriydi .	NDC
Bir süre bakıştıktan sonra , " Tanıyamadın değil mi ? " dedi . " Haklısın . Az önce konuştuğun Nazlı ile en ufak bir benzer yanımızın olmadığını ben	de	biliyorum .	NDC
... bir arkadaşının babama " Lütfullah , bu çocuğun sınırsız bir düş gücü var . Sen bunu okuldan mahrum etme , " demesi üzerine Şişhane Yokuşundaki Evliya Çelebi İlkokuluna yazdırıldım bu kez . Evliya Çelebi İlkokulun 4-B sınıfı	da	bambaşka bir dünyaydı .	DC
Ay ışığında basamaklara oturur , denizi , yıldızları seyrederlermiş uzun uzun . Geceleri kendisine aşk şiirleri okuyan romantik sevgilisinin , gündüzleri	de	Meltem adlı başka bir kızla birlikte olduğundan haberi yokmuş henüz .	NDC
Bir süre , garip bir tutkuyla bağlı olduğumuz Ankara ' dan konuştuk . Yaşamlarımıza sokak sokak sokularak bir tür bağımlılık yaratmıştı . İkimiz için	de	çok derin anlamlar taşıyordu kent .	NDC
 Annesi, babası, kardeşi, bütün ailesi İstanbul da yaşıyordu. İlk, orta ve lise eğitimini de yine orada tamamlamıştı. Sonra ani bir kararla , üstelik Hukuk Fakültesini	de	yarım bırakarak , anneannesinin yanına gelip Ankara ' ya yerleşmesinin nedenini merak ediyordum .	NDC
 " Bunda şaşıracak ne var ? Yalnız ben değil , bu evdeki her şey konuşur . Şöminenin üzerinde duran şu çenesi düşük kuru kafayı görüyor musun ? Benden	de	gevezedir o .	NDC
Ne kadar tuhaf , hayatımda bütün arkadaşlarımı defalarca gördüm	de	 , şu Osman ' a bir daha rastlamadım .	DC
Sahneyi terk etmeye hazırlanan bir aktris gibiydim . Zekâm şahlanmıştı sanki . Espriler yapıyor , kurnaz hamlelerle Meltem ' i yavaş yavaş mat ediyordum . O gece , Ege telefon edip yazdıklarımdan sonra bu kez	de	zekâma hayran olduğunu ele veren sesiyle böyle bir şeyi neden yaptığımı sordu . 	NDC
Birincisi , ilgili araştırmada , Trakya Üniversitesi Eğitim Fakültesi ' ndeki öğretmen adaylarının ,  ' Ata ' yı unutma '  davranış ya da tutumlarının , bu okulda ortaya çıkıp çıkmadığına ilişkin veri yoktur . Bu konuda veri/veriler elde etmek için , son sınıf öğrencilerine uygulanan anketin , bu öğrencilere bu okula girdiklerinde	de	uygulanıp , aradaki farka bakılması gerekirdi .	NDC
Ülkemizde yaklaşık 60 eğitim fakültesi vardır ; yalnızca birinde yapılan bir araştırmanın sonuçlarının tüm öğretmen adaylarına genellenmesi ne derece sağlıklı bir yaklaşımdır . Kısa bir süre önce TÜEF ' den ayrılıp şu anda bir başka eğitim fakültesinde görev yapmakta olan Prof . Dr . Cevat Celep , bu araştırmayı , hiç değilse , yeni okulundaki öğrenciler üzerinde	de	gerçekleştirdikten sonra , sonuçları basına verme inceliğinde bulunsaydı , toplanan veriler , ulaşılan yargılar ( yorumlar ) açısından , söz konusu araştırmanın geçerlilik ve güvenirliliği , kuşkusuz daha bir yüksek olurdu .	NDC
İstanbul ' un Anadolu yakasında Kadıköy ve Üsküdar ' da bazı ev ve işyerlerini su bastı . İSKİ ve itfaiye ekipleri , özellikle tıkalı mazgalları açmak için seferber oldu . Ancak bu arada yollarda göletler oluştu . Avrupa yakasında ise Alibeyköy , Eyüp gibi alçak semtlerde	de	yağış yüzünden kimi ev ve işyerleri sular altında kaldı .	DC
E-5 karayoluna çıkan araçlar , aniden bastıran sağanak yağış nedeniyle yolda kaldı . Avcılar- Yenibosna arasında kitlenen trafik yurttaşlara adeta bir işkence yaşattı . Zeytinburnu-Eminönü arasındaki hızlı tramvay seferlerinde	de	sabah saatlerinde yağış yüzünden gecikmeler meydana geldi .	DC
Sağanak , Narlıdere Şehitlik Kavşağı , Konak Mithatpaşa Caddesi , Güzelyalı , Karabağlar ve Çınarlı ' da yollarda su birikintisine yol açtı . Bu nedenle trafikte sorun yaşanırken bazı araçlar yolda kaldı . Bazı semtlerde	de	ev ve işyerlerini su bastı .	DC
16 Kasım 2002 tarihli Cumhuriyet gazetesinin birinci sayfasında , Trakya Üniversitesi Eğitim Fakültesi ( TÜEF ) öğrencileri üzerinde yapılan araştırmanın sonuçlarına dayanılarak  ' Öğretmen adayları Ata ' yı unuttu '  başlığı altında bir haber yer aldı . Benzer bir haber	de	yukarıda belirtilen tarihin öncesinde ve sonrasında , iki kez Milliyet gazetesinde yayımlandı .	DC
 Başka bir açıdan bakıldığında , Trakya Üniversitesi Eğitim Fakültesi ' nde Ata ' yı sevmeyen , bu nedenle	de	laik , demokratik cumhuriyete karşı öğretmenler yetiştiriliyor anlamına gelen bu haber ,	NDC
kuşkusuz tüm Cumhuriyet okurları gibi , okulumuzdaki çok sayıda öğrenci ve öğreticiyi	de	derinden sarstı , çok üzdü .	NDC
Bu konuda veri/veriler elde etmek için , son sınıf öğrencilerine uygulanan anketin , bu öğrencilere bu okula girdiklerinde de uygulanıp , aradaki farka bakılması gerekirdi . Belli bir konuya ya	da	nesneye yönelik tutum , alışkanlık , eğilim , yaklaşım ya da dünya görüşü gibi özellikleri kapsayan , eğitimbilim açısından ,  ' duyuşsal davranışlar '  denen insan niteliklerinin çok uzun bir zaman diliminde oluşturulabileceğini ya da değiştirilebileceğini bilimsel kaynaklar açıklıkla ortaya koymaktadır . 	NDC
Bu konuda veri/veriler elde etmek için , son sınıf öğrencilerine uygulanan anketin , bu öğrencilere bu okula girdiklerinde de uygulanıp , aradaki farka bakılması gerekirdi . Belli bir konuya ya da nesneye yönelik tutum , alışkanlık , eğilim , yaklaşım ya	da	dünya görüşü gibi özellikleri kapsayan , eğitimbilim açısından ,  ' duyuşsal davranışlar '  denen insan niteliklerinin çok uzun bir zaman diliminde oluşturulabileceğini ya da değiştirilebileceğini bilimsel kaynaklar açıklıkla ortaya koymaktadır . 	NDC
 Yeni hükümette Gül ' ün Dışişleri Bakanı ve Başbakan Yardımcısı olması bekleniyor . Erdoğan ' ın Gül kabinesini	de	büyük ölçüde değiştirebileceği belirtiliyor .	DC
Bu çerçevede yeniden test isteyen sendikanın talebiyle , İTÜ Ar-Ge İşletmesi ' nin aylarca süren ve uluslararası standartlara uygun tahkik ve deneylerle saptadığı sonuçlara karşın birkaç gün önce yeni bir tespit yapıldı . Özel bir şirketin gerçekleştirdiği tespitin sonucu henüz açıklanmadı . Oysa , İTÜ Ar-Ge İşletmesi ' nden profesör doktorlar Haluk Karadoğan , Tuncer Toprak , Faruk Karadoğan , Erdoğan Uzgider , Yard . Doç . Dr . Ercan Yüksel , Dr . Müh . Hatice Tokan , araştırma görevlileri Dr . Ergün Bozdağ , Dr . Özden Çağlayan ve Emin Sünbüloğlu  ' ndan oluşan uzman heyetin Eylül 2001 tarihli raporuna  ' ek cilt '  olarak hazırladıkları , Mayıs 2002 tarihli raporda	da	köprüdeki titreşimin giderilememesinin hâlâ ciddi risk oluşturduğu vurgulamıştı .	NDC
2002 ' de  ' çift başlı '  görüntüsü veren AKP hükümeti 2003 ' te	de	Erdoğan ' lı kabine oluşumu için yeni sıkıntılar yaşayacak .	NDC
Bakanlar Kurulu ' nda görüşülen Tıpta Mesleki Sorumluluk Sigortası Yasa Tasarı ' na , özellikle İngiltere ' den gelen hasta turizmi	de	eklenince , sorumluluk sigortası yaptıran doktorların sayısı , yılbaşından itibaren büyük bir artış gösterdi .	NDC
Bakanlar Kurulu ' nda görüşülen Tıpta Mesleki Sorumluluk Sigortası Yasa Tasarı ' na , özellikle İngiltere ' den gelen hasta turizmi de eklenince , sorumluluk sigortası yaptıran doktorların sayısı , yılbaşından itibaren büyük bir artış gösterdi . Söz konusu unsurlara az	da	olsa mahkeme sonucu alınan yüksek tazminatlar eklenince , sigorta yaptıran ya da çalıştığı kurum tarafından sigorta yaptırması istenen doktor sayısı 6-7 ayda 4 bini buldu .	NDC
Birincisi , ilgili araştırmada , Trakya Üniversitesi Eğitim Fakültesi ' ndeki öğretmen adaylarının ,  ' Ata ' yı unutma '  davranış ya	da	tutumlarının , bu okulda ortaya çıkıp çıkmadığına ilişkin veri yoktur . 	NDC
Kıbrıs sorununda da benzer bir anlayış egemen olamaz mı ? Çünkü , Türkiye tarafı güvenlik sorununu o kadar ileri noktaya götürüyor ki , Kıbrıs ' ın Türkiye açısından stratejik bir öneme sahip olduğu , askeri bakımdan bundan vazgeçilemeyeceği söyleniyor . Bunun doğru olup olmadığı bir yana , güvenliği ülke sınırları dışında aramaya kalkmanın sonu gelmez . Üstelik , Türkiye AB adayı bir ülke . Kıbrıs olsun Yunanistan olsun, bunlar	da	AB üyesi . Böylesine bir güvensizlikle uzlaşma üretmek nasıl mümkün olacak ? 	NDC
Karmaşanın yargı kararlarına uyulmamasından kaynaklandığını vurgulayan Ünlü ,  ' Mahkeme kararında yer almayan birtakım hukuki yorumlar ve Erdoğan ' ın genel başkanlıktan ayrılmaması sonucu bugünkü tablo ortaya çıkmıştır . Seçimlerin dürüstlüğü ilkesi	de	zedelenmiştir '  diye konuştu .	DC
Maalesef , Türkiye ' de hem kendi içimizle hem çevremizle bir türlü barışamıyoruz . Bunun zararını	da	hep birlikte çekiyoruz .	DC
Bunun zararını da hep birlikte çekiyoruz . Almanlarla Fransızları izlerken neden biz	de	böyle davranamıyoruz diye düşünmemek mümkün mü ?	NDC
Anayasa Mahkemesi ' nin , Yargıtay Cumhuriyet Başsavcısı Sabih Kanadoğlu ' nun başvurusu üzerine AKP ' ye Erdoğan ' ın kurucu üyelikten çıkarılması için ihtar verdiğini anımsatan Ünlü ,  ’ Anayasa Mahkemesi bu kararıyla Erdoğan ' ın kurucu üye olamayacağına karar verdi . Dolayısıyla Anayasa Mahkemesi , Erdoğan ' ın genel başkan olmasının	da	mümkün olamayacağına işaret etti '  dedi .	DC
Güney Asya da dondurucu soğuğun etkisinde . Son 24 saat içinde Hindistan ' da 74 , Bangladeş ' te	de	13 kişinin ölmesiyle , bölgede bir ayda ölenlerin sayısı 1792 ' yi buldu .	NDC
Son 5 yılda oynanan oyunlarda yapılan yasal kesintiler 1 .5 milyar doları aştı Atlar koştu devlet kazandı . Yasal kesintilerin yüksekliği tartışma konusu olan at yarışlarından devlete önemli miktarda kaynak aktarılıyor . Atçılık camiasında  ' at koşar baht kazanır '  sözü	de	at koşar devlet kazanır '  a dönüştü .	DC
Bahislerden , özel iletişim vergisi , eğitime katkı payı , KDV , Savunma Sanayii Destekleme Fonu , Yüksek Öğrenim Kredi ve Yurtlar Kurumu Fonu , Olimpiyat Fonu , Türk Tanıtma Fonu için kesinti yapılıyor . Oyunlardan belediyeler eğlence vergisi tahsil ediyor , Türkiye Jokey Kulübü	de	hisse alıyor .	DC
Geçen yıl oynanan oyunlarda 1 katrilyon 72 trilyon liralık hasılat elde edildi . Toplanan hasılattan KDV olarak 163 .5 trilyon , Savunma Sanayii Destekleme Fonu ' na 90 .8 , Olimpiyat Fonu ' na 9 .1 , Yüksek Öğrenim Kredi ve Yurtlar Kurumu ' na 31 .1 , Türk Tanıtma Fonu ' na 28 .1 trilyon kesildi . Belediyeler eğlence vergisi olarak 37 .2 trilyon tahsil etti , Türkiye Jokey Kulübü ' ne	de	149 trilyon liralık hisse ayrıldı .	DC
Bugün İncirlik hava üssünün hukuki statüsü nedir ? Bu sorunun yanıtını-1993 yılıyla sınırlı olarak- Uğur Mumcu  ' nun İncirlik ' ten kalkan ABD uçaklarının Kuzey Irak ' ta iki Irak uçağını düşürmesi nedeniyle Cumhuriyet ' te çıkan  ' İncirlik '  başlıklı yazısında buluyorum : ( O günkü sayıda İlhan Selçuk  ' un	da	40 yıldan beri İncirlik '  başlıklı yazısı var . )	NDC
Fransa ile Almanya arasında imzalanan Elysee Antlaşması ' nın 40 . yılı iki ülkede ve bu ülkelerin dünyanın dört bir yanındaki temsilciliklerinde törenlerle kutlandı . İstanbul ' da Alman Başkonsolosluğu ' nda	da	iki dilden parçaların söylendiği bir konser ve ardından bir kokteyl yapıldı .	DC
Fransa ile Almanya arasında imzalanan Elysee Antlaşması ' nın 40 . yılı iki ülkede ve bu ülkelerin dünyanın dört bir yanındaki temsilciliklerinde törenlerle kutlandı . İstanbul ' da Alman Başkonsolosluğu ' nda da iki dilden parçaların söylendiği bir konser ve ardından bir kokteyl yapıldı . Toplantının açış konuşmaları	da	ilginçti . Almanya temsilcisi bildirinin bir bölümünü Fransız temsilcisi de bir bölümünü okudu .	DC
Almanya temsilcisi bildirinin bir bölümünü , Fransız temsilcisi	de	bir bölümünü okudu .	NDC
Yüksek Seçim Kurulu ( YSK ) Başkanvekili Ahmet Hamdi Ünlü , hukukla inatlaşan Recep Tayyip Erdoğan ' ı eleştirerek  ' Genel başkanlıktan ayrılmaması sonucu bugünkü tablo ortaya çıkmıştır . Bu durum	da	seçimlerin dürüstlüğü ilkesini zedelemiştir dedi .	DC
ABD ' nin kuzeydoğusunu etkisi altına alan soğuk hava dalgası , New York ' tan Boston ' a kadar uzanan şeritte ısının eksi 20 ' ye kadar düşmesine yol açtı . Yetkililer , saatte 45 kilometre hızla esen rüzgârın etkisiyle , soğuğun eksi 60 derece gibi hissedildiğini belirtti . Meteoroloji soğuk havanın bugün ve yarın	da	etkili olacağını ve ısının biraz daha düşeceğini açıkladı .	NDC
Boston meteoroloji yetkilileri ise soğuğun önümüzdeki birkaç gün içinde 100 yıllık rekoru kırmasını beklediklerini söyledi . [paragraph] Güney Asya	da	dondurucu soğuğun etkisinde .	DC
İncirlik 1954 yılından beri 50 yıldır Türkiye ve dünyanın gündeminde . 1958 ' de ABD ' nin Lübnan ' a müdahelesinde , 1960 ' ta İncirlik ' ten kalkan U-2 casus uçağının Sovyetler Birliği semalarında düşürülmesinde , 1993 ' te Kuzey Irak ' ta Mig-29 uçağının düşürülmesinde , son olarak	da	Afganistan operasyonunda .	NDC
Geçen yıl ayrıca , eğitime katkı payı olarak 11 .3 trilyon , özel işlem vergisi olarak	da	33 .8 trilyon tahsil edildi . Bu yıl oynanacak oyunlardan çeşitli kesintilerle devlete ödenecek paranın 60 trilyonu bulacağı belirtildi . 	NDC
3 Kasım seçimleri sürecinde Erdoğan ' ın adının genel başkan sıfatıyla oy pusulalarında yer alması nedeniyle itiraz başvurusunda bulunulduğunu belirten Ünlü , YSK ' nin bu itirazları  ' fiili ve hukuki duruma göre karar verildiği '  gerekçesiyle reddettiğini söyledi . Tufan Algan	da	3 Kasım ile ilgili başvuruları değerlendireceklerini söylerken  ' Anayasa Mahkemesi ' nin verdiği karar gereğince eğer kurulca geçmişe yönelik hukuki bir karar alınması gerekirse , onu da görüşeceğiz '  dedi .	DC
Diyanet İşleri Başkanı Mehmet Nuri Yılmaz , 16 Ekim 2002 tarihli genelgesinde , baz istasyonlarının elektromanyetik radyasyon yaydığını , bunun iyonlaştırıcı özelliği bulunan radyasyonla karıştırıldığını kaydetti . Yılmaz , elektronik radyosyonun buzdolabı televizyon gibi ev aletlerinde	de	bulunduğunu öne sürdü .	DC
Dünyada böyle bir müessese var ve sapasağlam ayakta . Şu veya bu şekilde biten evlilikler	de	var ama bunu genele yayamayız .	DC
Özellikle metropol şehirlerde kadınlar artık maddi ve manevi bağımsızlığını ilan etmiş durumda . Kötü giden bir evlilikte çocukların da bir tampon olduğunu düşünmüyorum . Çocuk varsa sadece aynı evi paylaşan akrabalar gibi oluyorlar . Eskiden evlilik tek taraflı fedakarlıkla yürütülüyordu ama şimdi böyle değil . Artık tercih birlikte yaşamak bile değil , sadece flört etmek . Anadolu ' da ise kadın ne kadar çalışırsa çalışsın , söz sahibi olamadığı için örf ve adetlerin	de	etkisiyle durum daha farklı .	NDC
Öte yandan Çakıcı'nın da yurtdışına çıkması gereken 45 günlük sürenin emniyetten serbest bırakıldıktan sonra başlayacağı öğrenildi.  Hakkındaki " Kırmızı Bülten " ile aranma kaydı	da	düşürülen Çakıcı ' nın , işlemlerin tamamlanıp serbest bırakılmasının ardından yurtdışına çıkabilmek için pasaport işlemlerine başlayacağı öğrenildi .	DC
Türkiye ' nin , idam cezasını kaldırdıktan sonra Alaattin Çakıcı ' yı yeniden yargılamak talebiyle geçtiğimiz ekim ayında Fransa ' ya resmen başvuruda bulunduğu ortaya çıktı . Prof . Aysel Çelikel ' in bakanlığı döneminde , idam cezasının kaldırılması üzerine harekete geçen Adalet Bakanlığı , Fransız Adalet Bakanlığı ' ndan Çakıcı ' nın bu suçlardan	da	iadesini talep etti .	DC
Kıbrıs ' ta barış planlarının yapıldığı şu günlerde , Ada ' nın iki yakasında ekonomik işbirliğinin örnekleri sergileniyor . Kriz nedeniyle işşiz kalan 7 bine yakın Kıbrıslı Türk , çalışmak için her gün Rum Kesimi ' ne geçiyor . Türkiye ' deki ekonomik kriz kısa sürede etkisini Kuzey Kıbrıs Türk Cumhuriyeti ' nde	de	gösterdi .	NDC
Birçok işyeri kapanırken , işsiz kalan binlerce kişi yeni arayışlar içine girdi . Özellikle genç ve eğitimli nüfus , çareyi yurtdışına çıkmakta buldu . Kalanlar ise 1990 ' dan bu yana inşaatlarda çalışmak üzere Kıbrıs Rum Kesimi ' ne geçen gündelikçi işçilere katıldı . Son iki yıla kadar sayıları ancak bini bulan işçiler , krizin	de	etkisiyle 7 binlere ulaştı .	NDC
Masis , 19 Aralık ' ta Ankara ' da kalan mallar için müzayede düzenleyeceklerini ifade ederek , şöyle konuştu : Ben Ankara ' daki müzayedeyi yönetirken İstanbul , Adana ve İzmir ' de de naklen müzayede yayımlanacak . İsteyenler	de	telekonferansla anında ihaleye katılabilecek . Türkiye ' de ilk defa 4 kentte birden yapılan , naklen müzayede düzenliyoruz . "	DC
Geçen yılki fuarın 10 günde 100 trilyon ciro yaptığını belirten Yıldırım , bu yıl hedefin 200 trilyonun üzerinde olduğunu belirterek , " Arife günü rekor satış olacağını tahmin ediyoruz " diye konuştu . Yıldırım , " Önümüzdeki yıl Bulgaristan , Romanya , Suriye , Azerbaycan ve Yunanistan gibi ülkeleri	de	fuara çekmek istiyoruz . " şeklinde konuştu .	NDC
Rumların Pile ' ye rahatça girip çıktığını ancak kendilerinin Beyarmudu ' ndan kimlik kontrolünden sonra Pile ' ye geçtiklerini söyleyen Emirzade , şöyle devam ediyor : " Kendi hükümetimiz bize barikat kuruyor . İş imkânı yok , kimse Kuzey ' de çalışamıyor . Kazandıkları üç beş kuruşla	da	karınları doymuyor .	DC
Kocaeli ' ndeki Kandıra F Tipi Cezaevi ' nden tahliye edildikten sonra İstanbul polisince gözaltına alınan Alaattin Çakıcı , ikinci geceyi	de	emniyette geçirdi .	NDC
Fransa ' dan iade sözleşmesi gereği başka suçlardan yargılanamayan Çakıcı hakkında takdir yetkisini Adalet Bakanlığı ' nın savcılıklara bıraktığı öğrenildi . Savcılıkların	da	Çakıcı ' nın durumunun değerlendirilmesi için bir gece daha tutulmasını istediği bildirildi .	DC
İlginç olan başka nokta ise ciddi bir şekilde çiftler birbirini aldatıyor . Buna karşılık erkekler sadakatsizliklerinde evliliklerini ne olursa olsun sürdürüyor  boşanmıyorlar . Ancak kadın araya ikinci bir erkek girdiği anda boşanıyor . Günümüzde evlilikler artık sanal birlikteliklere dönüşmüş durumda . Bunca yıldır girdiğim boşanma davalarını	da	göz önünde bulundurursak evlilikler bitiyor .	DC
TBMM Başkanı Bülent Arınç ' ın türbanlı eşini Cumhurbaşkanı ' nı uğurlama törenine getirmesiyle tırmanan tartışmalar bağlamında bütün gözlerin çevrildiği MGK toplantısında askeri kanadın " yeni anayasa arayışları , türban ve ordunun siyasetteki yeri " konularında önemli mesajlar verdiği öğrenildi . Beş komutanın	da	türban konusunda konuştuğu ve hükümet programından pasajlar okuduğu toplantıda Başbakan Abdullah Gül , " Kuşkular yersiz , biz Cumhuriyet ' e gönülden bağlı bir ekibiz " dedi .	NDC
Mutlu insanlar var . Evliliklerin bitmemesi gerekiyor . Tüm gördüklerimize , tüm duyduklarımıza rağmen evlilik kurumu devam ediyor . Bu müessese yürümeli , yürüyor	da	. Bireysel mutsuzluklar asla genele yayılmamalı .	DC
Erdoğan ' a başbakanlık yolunun açılması için anlayış birliği var . 109 . maddede yapılacak değişikliğin cumhurbaşkanı kişiye özel olacağını söyledi . Cumhurbaşkanının bu tavrı netti . Sezer veto edebilir , referanduma getirebilir . Cumhurbaşkanı ile sürtüşen bir iktidar olmak istemiyoruz . Geçmişte , bu tür gerginlikler Türkiye ' ye pahalıya patladı . Ara seçimi düzenleyen 78 . maddeyi değerlendirmeye ağırlık vereceğiz . CHP	de	sıcak bakıyor .	DC
Bila , " Sizinle ilgili izlenimlerimi yazacağım , isterseniz , bu söylediklerinizi	de	yazayım , ancak teypteki ifadenizi de yazmak zorundayım " karşılığını verdi .	DC
Bila , " Sizinle ilgili izlenimlerimi yazacağım , isterseniz , bu söylediklerinizi de yazayım , ancak teypteki ifadenizi	de	yazmak zorundayım " karşılığını verdi .	DC
Bila , " Sizinle ilgili izlenimlerimi yazacağım , isterseniz , bu söylediklerinizi de yazayım , ancak teypteki ifadenizi de yazmak zorundayım " karşılığını verdi . Arınç	da	 Kastımın Erbakan ' la Erdoğan ' ı aynı kefeye koymak olmadığını da yazarsanız sevinirim  karşılığını verdi .	DC
Bila , " Sizinle ilgili izlenimlerimi yazacağım , isterseniz , bu söylediklerinizi de yazayım , ancak teypteki ifadenizi de yazmak zorundayım " karşılığını verdi . Arınç da " Kastımın Erbakan ' la Erdoğan ' ı aynı kefeye koymak olmadığını	da	yazarsanız sevinirim " karşılığını verdi .	NDC
Gül , Milli Savunma Bakanı Vecdi Gönül ve Dışişleri Bakanı Yaşar Yakış ' ın , AKP Genel Başkanı Tayyip Erdoğan ' ın , Avrupa ' da , " Türkiye ' de ordunun siyasete karışmadığını , ancak terörün tırmandığı dönemlerde devreye girdiğini belirterek yanıt verdiğini " vurguladıkları öğrenildi . Komutanlar , bu açıklamaların Başbakan ve resmi yetkililer tarafından	da	yapılmasında fayda olacağını ifade ettiler .	NDC
TBMM Başkanı Bülent Arınç , önceki akşam CNN Türk ' te Taha Akyol ' un sunduğu " Eğrisi Doğrusu " programında Milliyet ' te 26 Kasım 2002 tarihinde " Yanlışlara Ortak Olmam " başlığıyla yayımlanan röportajındaki ifadesinin farklı yansıtıldığını iddia etti . Ancak Arınç ' ın teyp kaydında	da	yer alan sözleri gazeteye aynen yansıdı .	NDC
3 Kasım seçimlerinin ardından ağır yenilgiye uğrayıp barajın altında kalan siyasi partilerin binaları sessizliğe gömülürken  partililer de yeni konjonktüre ayak uydurma çabasında . Gidenin arkasından ağlayan partililer  gelecek başkan adaylarıyla	da	dirsek temasına geçti .	DC
Başbakanlık ' ta gazeteciler ile sohbet eden Şahin , önceki hükümetin memur maaşlarına hedef enflasyona göre zam yapma sözü verdiğini , ancak kendilerinin 2003 zammını geçmiş enflasyonlara göre vermeyi planladıklarını söyledi . Şahin , " Fakat devletin devamlılığı esasını	da	gözardı edemeyiz . Sosyal boyutu da ihmal edemeyiz " dedi .	DC
Şahin , " Fakat devletin devamlılığı esasını da gözardı edemeyiz . Sosyal boyutu	da	ihmal edemeyiz " dedi .	DC
Komutanlar , Cumhuriyet ' in temel dayanağı olan laikliği sarsacak gelişmelere ve görüntülere izin verilmemesi gerektiğini vurguladılar . Türban konusunu	da	açan komutanlar , bu konuda Anayasa Mahkemesi ' nin kararı ile Cumhurbaşkanı ' nın yaptığı uyarıyı anımsatarak toplumu gerecek davranışlardan kaçınılması gerektiğini anlattılar .	NDC
Türban konusunu da açan komutanlar, bu konuda Anayasa Mahkemesi'nin kararı ile Cumhurbaşkanı'nın yaptığı uyarıyı anımsatarak toplumu gerecek davranışlardan kaçınılması gerektiğini anlattılar . Genelkurmay Başkanı ve dört komutanın	da	bu konuda söz alarak görüş birliğini ifade ettikleri öğrenildi .	NDC
Genelkurmay Başkanı ve dört komutanın da bu konuda söz alarak görüş birliğini ifade ettikleri öğrenildi. Bu konuda Cumhurbaşkanı Ahmet Necdet Sezer ' in	de	 Türban tartışması bitmiştir  diyerek son noktayı koyduğu belirtildi .	NDC
14 - 15 Aralık ' ta kongreye gidecek olan DYP ' de genel başkan adayları , il merkezlerini dolaşarak destek aramaya koyuldu . Genel başkanları Tansu Çiller ' in görevinden ayrılma kararını gözyaşları içinde karşılayan bazı partililerin	de	aynı " coşkuyla ! " yeni genel başkan adaylarına kucak açmaları dikkat çekti .	NDC
Başbakan Abdullah Gül ise " Bizim her söylemimiz ve davranışımızdan bazı sonuçlar çıkarıldığının ve kuşku duyulduğunun farkındayız . Ancak bu kuşkular yersizdir . Biz Cumhuriyet ilkelerine gönülden bağlı bir ekibiz . Cumhuriyet ' in temel niteliklerinden sapmayacak bir kadroyuz " karşılığını verdi . ( Toplumsal uzlaşma ) Başbakan Yardımcısı Ertuğrul Yalçınbayır	da	 Okuduğunuz ifadenin anlamı şudur ; sadece tek parti iktidarına ve Meclis ' teki sandalye çoğunluğuna dayalı bir anayasa yapılmayacağını biliyoruz . Anayasalar en büyük toplumsal uzlaşma ile düzenlenmesi gereken metinlerdir . Cumhuriyet ' in temel nitelikleri , Anayasa ' nın değişmez ilkeleri ve değiştirilmesi teklif edilemez maddeleri yeni anayasada yer alacaktır  dedi .	NDC
Milli Görüş ' ün oyu yüzde 40 ' tır '  diyor . Yok öyle bir şey . Her kesimden oy aldık . Sosyal demokratlardan	da	, ANAP ' tan da oy aldık .	NDC
 " Ben doğruların söylenmesinden yana olduğumu ifade ettim . Ertesi gün böyle bir başlık çıktı . Önce Serpil Çevikcan ' ı , sonra Fikret Bila Bey ' i aradım . Fikret Bila tekrar bana bu başlığın , çok	da	anlamsız bir şey çıkıyor burada ... 	NDC
Fikret Bila tekrar bana bu başlığın , çok da anlamsız bir şey çıkıyor burada ...  Virgülden sonra Tayyip Bey ' in	de	ismi gelince ikisi de aynı kefeye konmuş oluyor .	NDC
Fikret Bila tekrar bana bu başlığın , çok da anlamsız bir şey çıkıyor burada ...  Virgülden sonra Tayyip Bey ' in de ismi gelince ikisi	de	aynı kefeye konmuş oluyor .	NDC
Kopenhag Zirvesi ' ne kadar yetiştirilmeye çalışılan ikinci uyum paketinde son dakika değişikliği yapıldı . Aralarında Leyla Zana ' nın	da	bulunduğu DEP ' li milletvekillerine yeniden yargılama yolunu açan maddeyle türbanlı öğrencilerin üniversiteye dönüşünü sağlayacak af , paketten çıkarılarak Bakanlar Kurulu ' na sevk edildi	NDC
BDDK yayınladığı son raporunda , el konulan batık bankalardan toplam 3 bin 367 adet gayrimenkulun Tasarruf Mevduatı Sigorta Fonu ( TSMF ) bünyesine geçtiğini belirtti . Dün ayrıntıları Milliyet ' te yayınlanan ve BDDK tarafından	da	internet sitesine konulan  ' BDDK ve Faaliyetleri Hakkında Bilgilendirme '  ve  ' Bankacılık Sektörü Gelişmeleri - Kasım 2002 '  başlıklı raporda , fon bünyesine geçen 3 bin 367 adet gayrimenkulden 359 tanesinin satıldığını ve 93 milyon dolar gelir elde edildiğini açıkladı .	NDC
Kopenhag siyasi kriterlerinin büyük ölçüde yerine getirildiğini , son olarak Kıbrıs konusunun Türkiye ' nin önüne sürüldüğünü belirten askerlerin ,  Kaygımız odur ki , şimdi	de	Türk ordusunu bahane edecekler " dediği öğrenildi .	NDC
DSP ' den Şişli Belediye Başkanı seçilen , 3 Kasım seçimleri öncesi partisinden ayrılarak YTP ' ye katılan Şişli Belediye Başkanı Mustafa Sarıgül , şimdi	de	CHP saflarında yer almaya hazırlanıyor .	NDC
CHP Genel Başkanı Deniz Baykal , dün Sarıgül ' ü makamında ziyaret etti . Sarıgül ' ün Ramazan Bayramı sonrası partiye katılacağı mesajını veren Baykal , " Biz kız evine niyet beyanı için geldik . Kahveyi	de	çok iyi servis ediyor .	DC
Kahveyi de çok iyi servis ediyor . Gayet memnun ayrılıyorum , bayramdan sonra	da	düğünü yapacağız " dedi .	NDC
Geçtiğimiz haftayı yüzde 1 .49 düşüşle 13 .300 seviyesinden tamamlayan İstanbul Borsası bu hafta takas avantajının kullanılması ile yukarı doğru bir hareket deneyebilir . Faizdeki düşüş ve doların 1 milyon 525 liraya kadar gerilemesi	de	borsada umutları artırıyor .	DC
BDDK gibi özerk kurumların siyasete karışmış kişilerle yönetilmesinin doğru olmayacağını belirten uzmanlar , " İbrahim Türkiş aday adayı olarak seçilmese bile aktif politikada yer almış bir kişidir . Bu nedenle BDDK ' da görev alması doğru olmaz " şeklinde görüş açıkladılar . Türkiş , AKP ' den Antalya milletvekili aday adayı olmuştu . BDDK ' da halen bir ikinci başkan yardımlıcığı bir	de	üyelik boş bulunuyor .	NDC
İlk etapta Hamam markası için havlu ve bornoz koleksiyonları üzerinde çalışmaya başladığını anlatan Tarzi , işbirliği kapsamında " Hamam " isimli mağazalar	da	açacaklarını belirtti .	NDC
Tasarım markası olarak İdil Tarzi ' nin lisans haklarını Eke Tekstil ' e kiraladık . Dünyada	da	bunun örnekleri var .	DC
Koleksiyonumuzda havlu ve bornozların yanında hamam markalı sabunlar	da	yer alacak .	NDC
Denizli ' li Eke Tekstil ile yaptığımız görüşmeler sonucunda iki büyük markayı 1 kasımda beraber canlandırmaya karar verdik . Bunlardan bir tanesi " Hamam " markası . Diğeri	de	beraber projelendirmeye başladığımız " İdil Tarzi Home .”	NDC
Yurt dışında özellikle yabancı müşterilerin , Türk tahvillerini satın alması ileriye yönelik beklentilerinin iyimser olduğunu gösteriyor . IMF ' le başlayacak görüşmelerin seyri	de	endeksin kısa vadeli yönünde etkili olacak .	DC
Sadece serbest bırakılacak kredi dilimi için değil , 2003 yılında yapılacak olan borç servisinin	de	sorunsuz gerçekleştirilebilmesi için IMF ' in desteğine ihtiyaç var .	NDC
2030 vadeli eurobondun fiyatı 108 dolara geldi . Piyasa Kopenhag ' dan tarih için tarih alınması ihtimalinin kuvvetlendiğini düşünüyor . IMF ' le yapılacak görüşmelerde	de	gerilim yaşanmayacağı kanısı hakim .	DC
İyimser beklentiler sürüyor ancak parayı tek enstrümana yatırmak riskli olabilir . 12 Aralık ' tan önce portföylerde hisse senedi oranı yüzde 40 ' a çıkabilir . Yüzde 60 ' lık kısmı ise bono , repo ve likit enstrümanlar arasında dağıtabilir . Borsada AB ' den	de	bir sürpriz gelmezse 1 sentleri konuşmaya başlayacağız .	DC
Yatırımcının fon türünü  beklentileri ve risk profiline uygun olarak belirlemesi çok önemli . Bu yolla yatırımcı hangi yatırım enstrümanına yatırım yapmak istediğini belirlemiş ve tercihini portföy yöneticisiyle	de	paylaşmış oluyor .	DC
Bu yolla yatırımcı hangi yatırım enstrümanına yatırım yapmak istediğini belirlemiş ve tercihini portföy yöneticisiyle de paylaşmış oluyor . Fon yöneticisi	de	, kendisine tanınan sınırlar çerçevesinde ve yatırım fonunun karakterine bağlı kalarak görüş ve beklentileri doğrultusunda yatırım enstrümanlarında pozisyon alıyor .	DC
Fonlarda , pozisyonların değişken piyasa koşullarında her gün ayarlandığını	da	unutmamak gerekiyor .	DC
Büyükelçilik geziye milletvekillerini özel olarak davet ederken , isimleri Gül ' ün belirlediği öne sürüldü . TBMM Dışişleri Komisyonu üyesi Şirin	de	, büyükelçilikten kendisini arayan kişinin , " Bu hafta sonu programınız yoksa sizi uçak gemisine davet ediyoruz " dediğini söyledi .	DC
Vekiller , Esenboğa Havaalanı ' nda bindikleri uçakta , bel kemerleri dışında kollarından geçirilen kemerlerle	de	koltuklarına sıkıca bağlandı .	NDC
Yağcı , " Uçak o kadar hızlı fırladı ki , sadece ayaklarımız yerden kesilmedi , oturduğumuz koltuktan bile yükseldik . Sıkı bağlanmasaydık mermi gibi fırlardık " dedi . SERT İNİŞ YAPTILAR AKP ' lileri taşıyan uçak gemiye iniş sırasında	da	tekerlekle açılan bir parçanın çelik halatlara takılması nedeniyle sert bir iniş yaptı .	NDC
Soruşturmayı yürüten DGM Savcısı Ömer Süha Aldan ' ın talimatıyla soruşturmanın ikinci ayağı dün başlatıldı ve Ankara Dışkapı ve Eskişehir ' deki SSK hastanelerinin kardiyoloji servisinde görev yapan 6 doktorla , Trabzon , İstanbul , Eskişehir ve Ankara ' da çalışan 6 teknisyen gözaltına alındı . Gözaltına alınan 6 doktordan , 4 ' ünün Ankara ' da , 2 ' sinin Eskişehir ' de görev yaptıkları , Ankara ' da gözaltına alınan doktorların arasında Prof . Dr . Kenan Ömürlü ' nün	de	bulunduğu bildirildi .	NDC
Ankara ' da gözaltına alınan doktorların arasında Prof . Dr . Kenan Ömürlü ' nün de bulunduğu bildirildi . Ömürlü ' nün SSK dışında , Özel Yaşam Hastanesi ' nde	de	görev yaptığı ifade edildi .	NDC
Eskişehir ' den gözaltına alınan Doç . Dr . Barbaros Dokumacı ile Dr . Yusuf Erzurum ' un	da	daha önce askeri doktor olarak görev yaptıkları , ordudan ayrıldıktan sonra SSK ' da görev yapmaya başladıkları , Dokumacı ' nın Eskişehir ' de kardiyoloji servisini kuran isim olduğu öğrenildi .	NDC
Doktorlar hakkında çok sayıda kanıt elde eden savcılık , bazı firmaların hangi doktorlar için ne kadar harcama yapıldığını gösteren defterleri	de	ele geçirdi .	NDC
Savcılık , doktorların , firmalarca stend yöntemini öğrenmeleri için yurtdışındaki seminerlere götürüldüklerini , seminer bitiminde ise , kendi masraflarını karşılayan firmaların malzemelerinin alınması için çok sayıda reçete yazdıklarını saptadı . Eğlence yerlerine	de	götürülen doktorların , buna karşılık , hayali hastalara reçete yazdıkları ya da reçetelerde bir hasta üzerinde çok sayıda tıbbi malzeme kullanmış gibi gösterdikleri de tespit edildi .	NDC
oktorlar hakkında çok sayıda kanıt elde eden savcılık, bazı firmaların hangi doktorlar için ne kadar harcama yapıldığını gösteren defterleri de ele geçirdi. Savcılık, doktorların, firmalarca stend yöntemini öğrenmeleri için yurtdışındaki seminerlere götürüldüklerini, seminer bitiminde ise, kendi masraflarını karşılayan firmaların malzemelerinin alınması için çok sayıda reçete yazdıklarını saptadı. Eğlence yerlerine de götürülen doktorların , buna karşılık , hayali hastalara reçete yazdıkları ya da reçetelerde bir hasta üzerinde çok sayıda tıbbi malzeme kullanmış gibi gösterdikleri de tespit edildi . SSK ' nın reçeteler doğrultusunda firmalara ödeme yaptığı	da	saptandı . Öte yandan tıbbi malzeme satan firmaların üyesi oldukları Sağlık Derneği SADER tarafından uyarılmalarına rağmen ihalesiz fahiş fiyatla malzeme satışını sürdürdükleri anlaşıldı. 	DC
Öte yandan , tıbbi malzeme satan firmaların , üyesi oldukları Sağlık Derneği ( SADER ) tarafından uyarılmalarına rağmen , ihalesiz , fahiş fiyatla malzeme satışını sürdürdükleri anlaşıldı . Gaziantep Ticaret Odası Başkanı Mehmet Aslan , Diyarbakır ' daki kazanın ardından gündeme gelen ILS ( aletli yaklaşım sistemi ) cihazının Gaziantep Havalimanı ' na kurulması için kendilerinin	de	harcama yapabilecekleri konusunda Ulaştırma Bakanlığı ' na başvurduklarını , ancak kabul edilmediğini bildirdi .	NDC
Adli Tıp için verilen dilekçeyi suç duyurusu olarak kabul eden Ankara Başsavcılığı , bir soruşturma daha başlattı . Bu soruşturma	da	önceki takipsizlik kararı gerekçe gösterilerek 3 Mayıs 2002 ' de kapatıldı .	DC
Kumarhaneler ABD ve Avrupa ' da sınırlıdır ama vardır . Bunları iyi kontrol etmek gerekir . Kara para aklama yöntemi olarak kullanmalarına	da	izin verilmemelidir .	DC
 İnternet üzerinden yapılan başvuruların bulunduğu servis sağlayıcıda oluşan bir sorun nedeniyle web sitesine ulaşılamayınca yönetim kurulu başvuru süresini iki gün uzatma kararı aldı . Buna göre öğrenciler 15 Ocak saat 17 .00 ' ye kadar başvuru işlemlerini yapabilecekler . Lise ve ilköğretim öğrencilerinin katılabildiği yarışmada projelerin yüklenmesi süresi	de	özellikle " yatılı " okuyan öğrencilerin istekleri doğrultusunda sömestr tatilini de içine alacak şekilde 7 Şubat ' a uzatıldı .	DC
Lise ve ilköğretim öğrencilerinin katılabildiği yarışmada projelerin yüklenmesi süresi de özellikle " yatılı " okuyan öğrencilerin istekleri doğrultusunda sömestr tatilini	de	içine alacak şekilde 7 Şubat ' a uzatıldı .	NDC
SSK ' ya fahiş fiyatla tıbbi malzeme satılmasına ilişkin yürütülen Neşter Operasyonu ' nda neşter , firmalardan sonra bu kez	de	doktorlara indi .	NDC
Irak televizyonları , BM silah denetçilerinin teftiş haberlerine geniş yer ayırarak , " Yine bir şey bulamadılar " başlıklı haberler yapıyor . ABD ' nin , " Iraklıları	da	Saddam ' dan kurtaracağız " tezi , pek rağbet görmüyor .	NDC
1988 ' den itibaren Türkiye ekonomisi zaten bir kumarhane ekonomisine dönüştü . Yani sadece faiz ve rant gelirlerinden , özellikle kur ve faizle oynayarak gelir elde edenlerin ekonomisine dönüştü . Kumarhane ekonomisinden başka çıkış yaratamayanların kumarhaneleri resmileştirmekten başka seçeneklerinin olmadığı	da	düşünülebilir . İkincisi ekonomiyi canlandıracak diye toplumsal etiği olduğu gibi sarsacak ve toplumsal yıkıntılar yaratacak bu tür yöntemlere hiçbir çağdaş ülke başvurmaz .	DC
Bağdat ' ı sabahın erken saatlerinde kaplayan sis perdesi , Irak ' ın geleceğini iyiden iyiye görünmez kılan bulutlarla kıyaslandığında çok	da	ürkütücü değil .	NDC
Gelecekleri çok uzaklarda masaya yatırılmış bu insanlar , önce İran ' la , ardından	da	ABD ile çatışarak , savaşa , ambargoya ve yokluğa alışmış durumda .	NDC
Gelecekleri çok uzaklarda masaya yatırılmış bu insanlar , önce İran ' la , ardından da ABD ile çatışarak , savaşa , ambargoya ve yokluğa alışmış durumda . Belki	de	bu yüzden savaş boruları ötmüyor , hayat gündelik koşuşturmalar içinde akıp gidiyor .	NDC
Görüş mesafesi 3 .5 kilometre . Bu	da	uçak inişi için yeterli .	DC
Bu kez ,  ' pisti biz finanse edelim '  dedik . O zaman	da	önümüze ihale yasası engelini çıkarıp biraz bekleyin '  dediler . " 	NDC
Bombaların taşıdığı seyreltilmiş uranyum , Irak ' taki kanser vakalarını artırmış . Kan kanseri olan Leyla	da	(  sağda  ) onlardan biri…	NDC
  Bu ILS cihazını  Sanayi Odası  Ticaret Odası  Borsa olarak biz alacağız dedik . Ama    Olay ILS cihazı ile bitmiyor . Pistte 37 metre kod farkı var ve pistin uzatılması gerekiyor . O 	da	ancak 1 .5 2 yıl sonra ihale edilir   yanıtını aldık .	NDC
İş Güvencesi Yasasındaki uygulama tarihini ileri atmak gibi bir planları olmadığını da vurgulayan Şahin atıl istihdamda izlenecek yolda kesin karar vermediklerini	de	belirtti . Şahin IMF istese de istemese de kamuda rahatlama için emekliliği gelenleri emekli etmeyi düşünüyoruz dedi.	DC
AKP  li milletvekillerinin Erbakan  ın iddiasıyla ilgili görüşleri şöyle  Eyüp Fatsa  Grup Başkanvekili   Erbakan  ın ismini seçim döneminde kullanmadık . Biz sadece Milli Görüş tabanından değil  bütün kesimlerden oy aldık .   Milli Görüş yüzde 40 oya ulaştı   demesi	de	yanlıştır . Biz bir defa yeni bir partiyiz .	DC
  Abid Efendi  ben Halil . Acelem var . Çıkacak mısın ?    Sıkıştın mı evlat ?    Yok  derdim o değil . Şarabımı alıp gideceğim	de	 .	DC
  Bilkent  te müstakil bir villa .    Demek Bilkent  te bir villa ...  Başka evlerimiz	de	var mı ?    Olmaz olur mu ? Bodrum  da  yat limanında harika bir villanız daha var .  	DC
  İşte  adamın aklını başından aldın . Nasıl yaptınsa yaptın  başardın bu işi . On sekiz yıllık karısından ayrılıp seninle evlendi .         Memnun olmamış gibisin ?         Yok canım ...          Hakikaten  bir şey sezdim sesinde .  Biliyorsun  eskiden beri ben	de	beğenirdim seni .	NDC
  Ne kadar ilginç ...  Yaşamınızın elinizden alındığını düşünüyorsunuz  size yeni bir yaşam sunulduğunu değil .         Evet  öyle düşünüyorum . Haksız mıyım ?         Bunu kim yapıyor acaba ? Bakın  benim	de	aklıma takıldı bu .	NDC
geçen hafta getirdim birini çok	da	genç fakat ben uyuyunca cüzdanımı alıp güven olmuyor ki üç bin dolar gitti ... 	NDC
Marx  Hegel sisteminin büyük başarısı diyalektiği almış  idealizmini ise son derece kapsamlı bir eleştiri süzgecinden geçirmiş  kendi deyimiyle  baş aşağı duran Hegel felsefesini ayakları üzerine oturtmuştur  . Diyalektik Materyalizm  dönemin büyük bilimsel devrimleriyle	de	beslenmiş ve kanıtlanmıştır .	DC
Burada Felatun Bey ile Rakım Efendi ve Jön Türk romanları arasında otuz yıl geçtiğini ve Jön Türk  ün Beşir Fuad  ın intiharından sonra yazıldığını anımsayalım . Aykırı fikirleriyle kafalarını karıştırdığı Tanzimat yazarlarını  Beşir Fuad intiharıyla	da	çok sarsmıştı .	NDC
Kimi zaman eski metinlerdeki klasik üslûbu kullanır  yer yer kişilerin  özellikle de Bihruz'un  konuşma ve düşünme üslûbunu taklit eder . Mutlak bir anlatı üslûbunu benimsememesi  onun mutlak anlatıcı işlevini	de	kısıtlar .	DC
İlk olarak  öğle çıkışında kartlarımızı vermedik  kart toplayan öğrenciye numaralarımızı ve adlarımızı yazdığımız birer kâğıt verdik . Yani ona   Biz kartımızı vermiyoruz  sen kes sesini  git idareye haber ver   dedik . Birkaç arkadaşımıza	da	aynı öneride bulunduksa da kimse yanaşmadı .	DC
Doğru Muzaffer Beyin odasına gittim  yerinde yoktu . O yıllarda lig maçlarında hakemlik	de	yapıyordu  odacı onun federasyona gittiğini söyledi . Her adım başında  iki üç çocuk benden kartını soruyordu .	NDC
O şaşkın ya da sinirlenmiş gibi elini diğer eline ses çıkaracak şekilde vurarak  Vay  sen nasıl böyle söylersin ?  dedi . Ben de ona   Kendisine güvenen herkes söyler  siz	de	söyleyin   dedim .	DC
İçimi  dışımı yenileyip baştan yarattı beni . Çok	da	başarılı oldu üstelik . Eline sağlık .  	NDC
Halen sigortalı olan hekimlerin  yılda 50 ile 500 milyon lira arasında değişen primler ödediğine dikkat çeken Fırat  özel sağlık kuruluşlarında bu fiyatların çok can yakıcı olmadığını	da	sözlerine ekledi .	DC
 AB içinde birlikte var olacak Türk ve Rum halkları için soruna güvenliğin ötesinde bakılması gerekmez mi ? Fransızlar  eğer geçmiş tecrübeler açısından baksalardı  Almanlara hiç güvenmemeleri gerekirdi . Böyle düşünen Fransızlar hep vardı  fakat aklıselim sahibi Fransız siyasetçiler bu tür   kaygı   lara itibar etmek yerine geleceğe baktılar . Onların haklı olduğunu aradan geçen 40 yıl doğruladı . Bu işbirliği her iki ülkeye büyük olanaklar sağladı . Kıbrıs sorununda	da	benzer bir anlayış egemen olamaz mı ?	NDC
SPY  ye göre parti sicillerinin Yargıtay Cumhuriyet Başsavcılığı tarafından tutulduğunu kaydeden Ünlü  Başsavcılığın parti genel başkanlarının adlarının sorulduğu tarihte 6 aylık ihtar süresinin dolmaması nedeniyle mevcut fiili ve hukuki duruma göre parti genel başkanlarının adlarını YSK  ye bildirdiğini anımsattı . Ünlü  YSK  nin	de	3 Kasım  da seçimi yapabilmek için mevcut fiili ve hukuki duruma göre gönderilen genel başkan isimlerine oy pusulalarında yer verdiğini söyledi .	NDC
Tufan Algan da 3 Kasım ile ilgili başvuruları değerlendireceklerini söylerken   Anayasa Mahkemesi  nin verdiği karar gereğince eğer kurulca geçmişe yönelik hukuki bir karar alınması gerekirse  onu	da	görüşeceğiz   dedi .	NDC
Bu arada Çakıcı  nın aramaları nedeniyle Interpol Daire Başkanlığı  İnfaz Büro Amirliği  nden gelen yazıyı  Adalet Bakanlığı  na gönderdi . Böylece hafta sonu mesaisine bakanlık	da	katıldı .	NDC
Adalet Bakanı Cemil Çiçek   çete  den   cinayete azmettirme  ye kadar pek çok suçtan 456 yıl hapsi istenmesine rağmen sadece 5 yıl 1 ay hapis cezası alan  önceki gün	de	tahliye edilerek serbest bırakılan Alaattin Çakıcı hakkında yargının yapacağı bir şey olmadığını söyledi .	DC
Evlilik aslında dünyada en sağlam müessesesidir . Roma  dan gelen bir formdur . Roma  dan beri ekonomik  politik sistemler değişmiş ama evlilik kurumu aynı çizgide kalmıştır . Batıda boşanmalar artıyor ancak gözden kaçan  boşananların	da	bir süre sonra tekrar evlenmesi .	NDC
Milliyet  i arayan Arınç   Yanlışlara ortak olmam  haberindeki ifadenin rahatsızlık yarattığını  Erdoğan  ın Danimarka  dan arayarak tepki gösterdiğini belirtti . Ankara Temsilcisi Fikret Bila	da	  Arınç  ı arayarak   Bir serzenişte bulunmuşsunuz  ama sözleriniz teypte böyle  isterseniz deşifresini okuyayım  dedi . Deşifre metnini dinleyen Arınç   Bunu demiş olabilirim  ama kastım bu değildi . Ben Erbakan  la Erdoğan  ı aynı kefeye koymam  dedi .	DC
Ama benim istediğim , bu yaşıma dek yaşadığım , seçtiğim bir hayat değil ki bu ! " dedim . Benim kendime ait olan hayatımda	da	insanlarım var , kalabalıklarım , tenhalıklarım var . Ne bileyim ben , bambaşka beklentilerim var , vazgeçemeyeceğim bir özgürlüğüm var , kendime ait bir yalnızlığım var . "	DC
6 Edebiyatta okuyan bu çocuk bana yapay bir yakınlık göstererek yaklaştı . Okuduğum kitapların isimlerini öğrenmek istediğini , kendisinin	de	onları okuyacağını söyledi .	DC
Tayyip Erdoğan  ' la ilgili çıkan Anayasa Mahkemesi kararını dinlerken de aynı duygulara kapıldım . Bizdeki yargı kararlarının ve kanunların arkasında	da	geçmişten kalma bir hesaplaşma anlayışı yatmıyor mu ?	DC
Günümüzde artık evliliğe bakış açısı değişti , daha katı bakılıyor . Özellikle metropol şehirlerde kadınlar artık maddi ve manevi bağımsızlığını ilan etmiş durumda . Kötü giden bir evlilikte çocukların	da	bir tampon olduğunu düşünmüyorum .	DC
Dolardaki düşüşte geçen cuma günü yurtdışı piyasalarda Türk eurobandlarına gelen talepte etkili oldu . Eurobondlara gelen talebin etkisiyle içeride	de	bono faizlerinin gerilemesi dolara satış olarak yansıdı .	NDC
Kalanların prosedürlerin tamamlanmasının ardından ihale yöntemiyle satılacağı ifade edilen raporda , " Ayda iki - üç adet ihale yapılarak , piyasadaki fiyatların asgari düzeyde etkilenmesine özen gesterilecektir " denildi . Batık banka patronlarından tahsilata önem verildiği belirtilen raporda , borçlularla gönüllü ödeme yollarının arandığı , açılan davalarla	da	hukuk mücadelesinin verildiği anlatıldı .	DC
Türkiye ' nin tanıtımına büyük destek sağlayacaktır . Türkiye ' nin imaj ve marka yaratmasında	da	avantaj sağlayacaktır .	DC
Herkes gülerken , kimi de yuh çekerken -askerdir , hoş görülür aslında- onlar	da	önlerini kapamaya çalışırken neye uğradıklarını şaşırmışlardı .	NDC
Baleye karşı da bir yeteneğimin olmadığı kısa sürede ortaya çıktı . Piyano  bale derken bu arada ilkokula başlama yaşım	da	gelmişti . Turizm ve Tanıtma Bakanlığının memur almak için bir sınav açtığını gazetede okumuştum .	NDC
Annesi , babası , kardeşi , bütün ailesi İstanbul da yaşıyordu . İlk , orta ve lise eğitimini	de	yine orada tamamlamıştı .	DC
Ne kadar tuhaf , hayatımda bütün arkadaşlarımı defalarca gördüm de , şu Osman ' a bir daha rastlamadım . Aradım ama kasetlerde	de	bulamadım onu . Kaderin oyunu işte . Bizim Osman ' ı kaydetmemiş . Ne yaparsın ?	NDC
Savcılık, doktorların, firmalarca stend yöntemini öğrenmeleri için yurtdışındaki seminerlere götürüldüklerini, seminer bitiminde ise, kendi masraflarını karşılayan firmaların malzemelerinin alınması için çok sayıda reçete yazdıklarını saptadı. Eğlence yerlerine de götürülen doktorların , buna karşılık , hayali hastalara reçete yazdıkları ya da reçetelerde bir hasta üzerinde çok sayıda tıbbi malzeme kullanmış gibi gösterdikleri	de	tespit edildi . 	DC
Bu aralık Mösyö Piyer etekleri yerlere sürünür derecede uzun bir rop dö şambr giymiş , başında rengâmiz tüylerle müzeyyen bir kadın şapkası , iki koltuğunda da birer bordo şişesi olduğu halde birdenbire meydana çıkıyor : " Kes köse kö lamur ? Se tön tambur ! se tön tambur ...  me mon şer kavaliye ! javü anfen kö lö bo seks vo miyö kün lapen ! " diye haykırıp sıçradıkça lândoyu deviriyorlar ! Lândonun içinden bir çift kaplumbağa ile bir	de	fino köpeği zuhur ediyor .	NDC
B tipi tahvil bono fonlarında ise minimum yüzde 51 Hazine bonosu devlet tahvili taşıma zorunluluğu bulunuyor . Ortalamada bu tür yatırım fonlarının yüzde 71 oranında Hazine bonosu taşıdığı görülüyor . Tür grubunda yer alan kimi yatırım fonları yüzde 50 minimum düzeydeyken bono oranını yüzde 100  lere kadar çıkartan yatırım fonları	da	görülebiliyor .	DC
Tür grubunda kimi yatırım fonu yüzde 25  lik minimum hisse senedi oranında seyrederken hisse senedi oranını yüzde 90  ların üzerine taşıyan yatırım fonları	da	yok değil .	DC
Ermeni Ante olmasa intihar edecek duruma gelmişti . Halil her gün şarap satın almaya gidiyor  bu bahaneyle	de	tek dostu olan Ante'yle konuşuyordu . Ante bu genç ressamın her sırrını biliyor ve onu çok iyi anlıyordu .	DC
Ante  Şemsî Ahmed Paşa'ya giderek görevinden ayrıldığını  bu yüzden	de	yeni bir iş kurması gerektiğini söyledi . Evliliğin birkaç ay ertelenmesini rica etti .	NDC
Bazen şiddetleniyor  bazen	de	tümüyle kesiliyordu .	NDC
Turistik gösteri ve törenler bölümüne verilmiştim . Küçük bir masam vardı . Zar zor bir	de	kül tablası edinmiştim .	NDC
Üç kişiydik   diyor İlhami   Ayı  ben  Macit . Suzan'ın boynuna ip bağlayıp götürdük .  Tiksinse	de	uzaklaşamıyor yanından .	DC
Sulu gözlüydün Nesli  bunu ne kadar gizlemeye çalışsan	da	 utanıyordun değil mi  bir devrimciye yakışmayan güçsüzlüklerdi bunlar  başaramıyordun .	DC
Fikirleri o dereceye kadar tevessü edince nasraniyet dahi kalmaz . Bunlara Avrupalı demek caiz olabilecekse	de	sözün doğrusunu söyleyelim ki terakkiyât-ı fikriyenin o derecesi Avrupa  da mehâsin-i ahlâk gayretinde bulunanlar nezdinde de istihsan edilememektedir .	DC
 Bihruz Bey yağız bir ata binmiş landoyu takip ediyorsa	da	bir türlü yetişemiyor  atı kırbaçlıyor  sürüyor  koşturuyor  tamam landoya yetişeceği vakit hayvan geri geri gitmeye başlıyor	DC
Nurhan masanın üzerindeki kitabı göstererek   Bu eseri seçti   dedi . Sabahat heyecanla  Ne kadar güzel  ne kadar güzel . Aslında bu eseri okumak  ondan sonra onun üzerinde konuşmak gerekirse	de	J .J . Rousseau  nun tezi hepimizi düşündürebilir .  	DC
Yani ona   Biz kartımızı vermiyoruz  sen kes sesini  git idareye haber ver   dedik . Birkaç arkadaşımıza da aynı öneride bulunduksa	da	kimse yanaşmadı .	DC
Başka bir çocuk  Hadi canım  yediğin tokatları kulağımızla duyduk   deyince Muzaffer Ateş  in ellerini birbirine vuruşundaki oyununu anladım . Keşke gerçekten beni dövseydi	de	bu yapaylığa gerek görecek kadar çapsız ve kişiliksiz bir öğretmen olmasaydı diye düşündüm . 	DC
Ve ülkelerinin insanlarını seviyorlardı . Ama kendilerini her ne kadar vatan uğruna ölmeye hazırız deseler	de	her şeyin üzerinde seviyor .	DC
Ege  nin uykusuzluğu  halsizliği bundanmış meğer .      İçki alabilmek için anneannesinin armağan ettiği Rus montürlü pırlanta yüzüğü Beyoğlu  nda bir emanetçiye verebilecek kadar çok sevdiği Ege  nin  Meltem  le olan ilişkisini öğrenince yıkılmış . Yalanla  iki yüzlülükle ilk karşılaşmasıymış bu . Büyük bir sarsıntı geçirmişse	de	  toparlanması fazla uzun sürmemiş . 	DC
O sinirle telefonun fişini çekmek için kabloya nasıl asıldıysam duvarın yarısı elimde kaldı . Gece direndiysem	de	  ertesi gün yine teslim oldum ona .	DC
Yine hiçbir şey söylemeden gidip karşı büfeden Raif Beyin sigarasını aldım . Saat beşe kadar zor bekledim . Eve ulaşana dek kendimi tuttuysam	da	  içeriye girer girmez hüngür hüngür ağlamaya başladım . 	DC
atıl istihdamda izlenecek yolda kesin karar vermediklerini de belirtti . Şahin   IMF istese	de	istemese de kamuda rahatlama için emekliliği gelenleri emekli etmeyi düşünüyoruz  dedi .	DC
Cebeci  Diyarbakır ve Malatya  da en gelişmiş askeri radar sistemi bulunduğunu belirterek  kaptan pilot askeri kökenli ve bu radar hakkında eğitimli olsa	da	bu radarı hukuken kullanmalarında sorun bulunduğunu söyledi .	DC
Çünkü fark ediyordum ki  babam genç kızlara ve kadınlara hiç	de	iyi gözle bakmıyordu  bu yüzden annemle arada bir tartıştıkları da oluyordu .	NDC
Medya halkın duygularına ve ihtiyaçlarına binaen birbirinden güzel yayınlar yaptı	da	bundan kim zarar gördü  ?	DC
Pazar günü oy kullanacağız . 1991 seçimlerindeki gibi tercih sistemi uygulanmadığı için seçilecek partinin milletvekili listesi	de	benimsenmiş olacak . Çünkü liderler sizin adınıza en iyi seçimi yaptılar !	NDC
UEFA Kupası ' nı almakla ülkeye büyük kötülük etti	de	biz mi ayrımına varamadık .	DC
Karıştır babam karıştır ... Beyin yıkama dedim	de	, aklıma yaşlı amca geliverdi . Pazar sabahı kongredeydim .	DC
İnsanlık eğitimi alsınlar diyorsunuz	da	Var mı o eğitimi verecek insan .	DC
Ben de severim ama pislik içinde otursun	da	göreyim .	DC
Herkes senin iyi bir yardımcı yönetmen olduğunu söylüyor . Gel	de	boyunu posunu bir görelim .	DC
Ve kendisi söyledi yani ben akşam da müsaitim , hatta yarın Birleşmiş Milletler'de toplantı var , yarın akşam	da	müsaitim , ne zaman isterseniz tekrar görüşebiliriz dedi .	DC
güvenlik , siyasi egemenlik ve ekonomi ( altyapı ve hizmetler ) olmak üzere üç başlığa ayırıyor ve esasen her başlıkta	da	, Irak'ın kendi yerli kapasitesinin hazırlanması , güçlendirilmesi ve devreye sokulması amacıyla hareket ettiğini söylüyor .	NDC
Baro , meslek sorunları için savaşırken , halkın dertlerine kayıtsız kalamazdı , kalmadı	da	. Derdi büyüten deprem Sakarya , 17 Ağustos depreminden en fazla etkilenen illerden .	DC
Mesajlaşma uzun sürünce Kız arkadaşımla , kavga ettik diye açıklama yaptı	da	oradan biliyorum detayları . Üstelik kavga da mesajla yapılmış .	DC
Niye bu şimdiye kadar açıklanmadı	da	böyle bir ortamda açıklandı , onu öğrenmek istiyorum ...	DC
2001 yılındaki krizi takiben 2002 yılı	da	oldukça durgun geçmişti . 2003 yılı başlarında da Irak savaşı patlak verdi .	NDC
Dünya Bankası'nın itirazlarına rağmen , taslakta Türk şirketlerini korumaya yönelik düzenlemeler	de	bulunuyor . 18 Ekim Dünya Bankası , IMF ve Avrupa Birliği ile çetin pazarlıklara sahne olan yeni devlet ihale kanunu taslağı büyük ölçüde tamamlandı .	NDC
Tabi bu ikinci bir tezkerede onay anlamına gelmeyeceğini ta o zamanda da söyledik ve Sayın Başbakan	da	bunları ifade etti . Şu anda ki işin tabi ikinci tezkereyle ilgili sürekli olarak şu tarihde bu belirlenmeli yani denildiği zaman , dendi , adı bile kondu	NDC
Demoların yanında kitabı tanıtan birer	de	broşür yer alıyor . Ancak bu broşürleri yanınıza alıp yolda karıştırabileceğinizi sanmayın !	NDC
Koltukların kollukları onların birbirlerine yaklaşıp film boyunca konuşmalarını engelleyemez . O hoş ve	de	oldukça boş muhabbetlerinin nedense sizi de ilgilendirdiğini düşünerek fısıldamayı tercih etmezler . Konuşur , gülüşür , eğlenirler .	NDC
Karbonhidrat Diyeti : Özellikle kadınların karbonhidratlı gıdalara eğilimi yüksektir . Ekmek ya	da	makarnasız kendini doymuş hissetmeyenler bu diyeti uygulayabilir .	NDC
Sana kıyamıyoruz kızım . İşini çabuk bitir	de	in aşağıya . Tam kapıyı açıp içeriye gireceği sırada annesi aşağıdan tekrar seslendi .	DC
Göz tansiyonu demek gözün içinde basıncını sağlayan bir sıvı yapılır . Bir bölgeden	de	atılır . Eğer yapılan sıvı , atılan sıvıdan daha fazlaysa , gözün basıncı yükselecektir .	DC
Türkiye'deki yatırım ortamının iyileştirilmesi ve yabancı sermayenin daha fazla miktarda Türkiye'ye çekilebilmesi için yürütülen çalışmalar kapsamında kurulan teknik komiteler , değerlendirme toplantıları yapıyor . Hazine Müşteşarlığı'nda bu konuya ilişkin çalışmalar , bugün	de	sürdürülürken Yabancı Sermaye Yasa Tasarısı'nın da hazır olduğu belirtildi .	NDC
Çalıştırmak için tek yapmanız gereken , Bullet Kaplarından ya	da	Parti Kupalarından birini Yüksek Devirli Güç Bölmesine yerleştirmek ve basmak . Ne kadar basit değil mi ?	NDC
Siyah var her zamanki gibi , beyaz , uçuk pembe , turkuaz , puro rengi , pas rengi ve lapis kullandım . File	de	bolca kullanıldı . Şimdi kimleri giydiriyorsunuz ?	DC
Bu okulların gelirlerinin yüzde 65’i her yıl personel giderleri olarak ödenir ve	de	bu yüzde 65’in yüzde 33’ü yani veliden aldığınız her 100 liranın 33 lirasını her ay siz devlete vergi diye geri ödersiniz .	NDC
Aldığınız sağlık kurulu raporu nedeniyle babanızdan almaya başladığınız yetim aylığı anneniz vefat etse de devam eder . Sağlık yardımlarınız	da	devam eder . Sahte danışmanlara dikkat !	DC
Bir şekilde çocukları muhafaza edebilirdik , ve madem depremden sağ kurtulmuştum , hiç değilse orada kalıp diğerlerine yardım etmeliydim , bir parça yıkıntıyı	da	ben kaldırmalıydım . Bu bir günah çıkarma değil , hakiki bir pişmanlığın ifadesidir .	DC
bankazedelerin durumunu benzetecek başka örnek bulamadı mı , buldu	da	gündem de kalmak için mi böyle hassas bir konuyu deşiyor	DC
Mimarlar Odası’nın MYK Merkez Yönetim Kurulu’nun güveniyle 2002 Şubat ayında Bilim Kurulu Başkanlığını , daha sonra	da	hem Bilim Kurulu , hem de Kongre Başkanlığını Haziran 2004 tarihine değin yürüttüm .	NDC
Ne kadar abuk bir iş olursa olsun , onun gerçekliğine karşısındakini ( figüranı ) ikna etmeye çabalıyor ... Ediyor	da	. Özet : Abuk olan ben değilim , durum , senaryo değil , sizsiniz !	DC
Peki ekonomik ve sosyal konseyin lafı çok edilir	de	pek bu toplanmaz . Ben konuyu biraz daha getirmek istiyorum .	DC
Yazıyoruz	da	ne yazıyoruz .	DC
takip etmeye çalışıyoruz kendilerini sahnelerde . pek ışıltılı bir gülüşü var , ses tonu	da	hoş . pek de gençmiş .	DC
Medeniyetler buluşmasına evsahipliği yapan İstanbul , tam	da	medeniyetlerin kavşağında olan bir düşünce , kültür ve siyaset merkezidir .	NDC
Birçok kişi de sırf bu konuyu anlayamadığı için daha başlamadan solculuktan istifa etti	de	, hayatını kurtardı . Efendim , diyalektik için kısaca zıtların birliği diyebilirsiniz .	DC
Galatasaray - Fener maçı var , onu	da	konuşabilirdik . Ama gündemde tabi ciddi ekonomi tartışmaları var Türkiye'de .	DC
Derviş , genel müdür yardımcılarının maaşlarının	da	2 milyar 750 milyon ile 5 milyar 166 milyon lira arasında değiştiğini belirtti .	NDC
işgale ortak olmaya Hayır deme cesaretini göstermiştir . Ve korkulan olmamış , ne ekonomi çökmüş ne	de	Türkiye krize girmiştir . Şimdi ABD'nin hedefinde Suriye ve İran var .	NDC
Loeb , bu sezon koşulan 15 rallinin 10'unu kazandı ve vatandaşı Didier Auriol'un 1992'de altı yarışla elde ettiği bir sezonda en fazla yarış kazanma rekorunu kırdı . Loeb , ayrıca bu sezon üst üste altı yarış kazanarak bu daldaki rekoru	da	eline geçirdi .	DC
Bu programın dışına çık	da	gör , krizin alası tepende patlar ...	DC
yoksa bu servis sağlayıcının ismindeki TNN kelimesi başka bir anlama mı geliyor	da	Türkiye ' deki böyle önemli bir haberi vermemiş olsunlar .	DC
Öğrencilerin Evet yanıtı vermesi üzerine de Şener , Bu basın gitsin	de	ondan sonra söyleyeyim , olmaz mı ?	DC
Şimdi eyalet sistemi hakkında bir soru geldi , buna ben eyalet sistemi diye formüle etmek istemiyorum	da	şöyle diyeceğim , Türkiye aşırı merkeziyetçi bir siyasal yapıya mı sahiptir ?	DC
Olmazsa Ankara'da olduğu gibi eski liderler birbiriyleriyle nasıl anlaşamıyordu ayrıldı . Orada	da	herhalde bu liderlerin yerine başkaları gelip de bu işi çözecekler . Bunun anlamı , çok zaman kaybederiz .	NDC
Bu akşam Avrupa Birliği büyükelçileriyle yemekte birarada olacaksınız . Öğleden sonra	da	Avrupa Birliği genel sekreteri ve diğer diplomatlardan brifing aldınız .	NDC
Yani her şeye rağmen vergi gelirlerinde zaten IMF	de	bunu öngördüğü için harcama kısılması yoluna gitmiş .	NDC
Hayır , sen sonuca bak ama , Türkiye’de bir terslik var yani . Şimdi şunu bitir	de	biz de bir şey söyleyelim .	DC
Günümüzde çok sayıda ülkede gözlemi yapılmayan bu parametrenin yapılar üzerindeki olumsuz etkilerinin çok iyi bilinmesi nedeniyle , matematiksel olarak hesaplanması için yöntemler araştırılmış ve sürüklenen yağışların gözlemi yapılmadan	da	hesaplanabilmesi için bazı formüller geliştirilmiştir .	NDC
Rumsfeld'in temaslarının ardından bin Amerikan piyadesi Özbekistan'a doğru yola çıktı . Özbekistan lideri Kerimov	da	, Amerikan ordusuna bir üs tahsis edildiğini açıkladı . Özbekistan Devlet Başkanı İslam Kerimov , Amerikan Savunma Bakanı Rumsfeld'le yaptığı görüşmenin ardından .	DC
Öğrencinin ağırlıklı bilim dalı ve item 2 Fen ve matematik öğrencileri , öğrencinin uyarılıp yerine oturtulması ve uyarıda bulunmadan yerlerine oturtulmaları konusunda farklı düşünmektedirler . Kabul kağıdı için idareye gönderme hususunda	da	matematik grubu diğer gruplardan farklı düşünmektedir .	NDC
Yoksulluk değil , açlık sınırının altında yaşayan , hiçbir gelecek duygusu olmayan bu insanlar aralarında her gün konuştukları konuyu bize de açıyorlar : Bir yazıverseniz	de	fıstığın çekisine 6 yerine 10 milyon lira verseler ...	DC
AB ile 40 yıla yakın bir süredir devam eden ortaklık ilişkimiz , her iki taraftan da kaynaklanan nedenlerle istenen hızda ilerlememiştir . Türkiye’nin bu süreçte önüne çıkan fırsatları değerlendiremediği	de	hepimizce bilinmektedir .	DC
Uyandırana Allah lanet etsin ! Gerçekten	de	insanın içindeki yalnız nikahlısına karşı beslediği cinsel hisleri , başkalarına karşı uykudadır .	NDC
Yurtdışında insanlar rahatlığa çok önem veriyor . Bu terlikler	de	güzellikten çok , rahatlık düşünülerek hazırlandı .	DC
Kendi kendime Adamlar alkol sevmiyorlarmış dedim ve beklemeye başladım . Yemek gelsin	de	, karnımı doyurayım . Neresinden bakarsanız bakın , yine de 3 saatlik bir uçuş ...	DC
- Hatırlıyor musun , yıllar önce diş hekimleri odası başkanı olmak istemiştin	de	247 oy eksikti .	DC
Bayram diye , herkes eş , dost , arkadaşlarını	da	dâvet etmiş ... Aya Nikola’nın şatafatlı iç mekânı , dört bir yanda mumlar nedeniyle , olağanüstü göz kamaştırıcı idi .	NDC
Midesinden rahatsızlandığı açıklanan ve bu nedenle Cumhuriyet Bayramı Töreni'ne katılamayan Yıldırım'ın sağlıklı olduğu gözlendi . Yıldırım , PAF takımlar arasındaki mücadeleyi	de	takip etti . Başkan maçtan sonra da soyunma odasına inerek takımı ve Zico'yu kutladı .	DC
Şimdi ona özenip yollara düşen kızların başına neler gelmez ki ! Yok eğer Türkiye değişti	de	biz farkında değilsek , pardon ...	DC
Herhangi bir millet , bir başka milletin bir despottan kurtulması veya daha insanca yaşaması için varlığını tehlikeye sürmemiştir ve sürmez	de	. Karşılıksız varlığını tehlikeye sürmek , ilahiliğine inanılan hususlar için söz konusudur .	DC
İş Kurumu ile Küçük ve Orta Ölçekli Sanayi Geliştirme ve Destekleme İdaresi Başkanlığı'nın da destek verdiği projeler ile bankacılık sektöründe meydana gelen işsizliğin yarattığı sosyal sorunların giderilmesi amaçlandı .  Projenin ilk ayağında işsiz bankacıların , bankacılık sektörü dışındaki alanlarda	da	istihdamına yönelik eğitim kursları yer alıyor . Bu konuda hazırlanan eylem planına göre İş Kurumu , işsiz bankacıların eğitimi için bir ihale açacak .	NDC
Köksal , internette Türkçeyi kullanmak için kişinin kişisel bilgisayarına Türkçe kullanmak istediğini belirten bir yazılımı bir kez yüklemesi ve metni kendisinin doğru yazması gerektiğini kaydetti . Yazılım kodunu yüklemeye üşenen ya	da	Türkçe harfleri taşınması gereksiz bir yük gibi gören kimi kişilerin , dili bozup yozlaştırarak bunun suçunu haksız yere yeni teknolojiye yüklemesinin şaşırtmaca olduğunu ifade eden Köksal	NDC
bayrama daha çok var , bekle	de	, gelince bayramlaş .	DC
Nerde onda o bilek , o yürek Ne alakası var diyeceksiniz ama işte bu elemanın da yarıştığı yarışı izlemiştim	de	oradan aklıma geldi . Volkan olsa herif bu kadar rahat mı olurdu ?	DC
Geçen yıl İsveç'in AB dönem başkanlığı sırasında Götebourg'ta yapılan toplantı , bu yıl	da	İspanya'nın AB dönem başkanlığı sırasında ABD'de düzenlenecek denilmektedir .	NDC
eve yeni geldim	de	okuyamadım ya yine niye kimse beni ciddiye almıyor .	DC
Çok güçlü ve kolay bir program . GNU lisanslı olması	da	çok büyük bir artı .	DC
Çok yakışıklısın hem de oyunculukta yeni olmana rağmen hayat bilgisindeki başarın kadar acemi cadıda	da	aynı performansı gösterdiğine inanıyorum .	NDC
Ama benim içimdeki müziğe dökülünce şarkılar çıkıyor . Ben insanları	da	çok gözlemlerim , başkalarının hikayelerinden çıkardığım çok şarkı vardır .	NDC
Sezonun 3. Grand Slam mücadelesi olan 118. Wimbledon Tenis Turnuvası'nda , tek erkeklerde İsviçreli Roger Federer 2. kez üstüste , tek bayanlarda	da	Rus Maria Sharapova ilk kez şampiyonluğu kazandı .	NDC
Benim iyi oynamam ya	da	kötü oynamam birden olay oluyor . İnsanlar en ufak bir açığımı yakalama derdindeler …	NDC
Kapatmadan önce " son bir fotoğraf gelsin	de	yorumlayayım " diye bekledim ya değdi .	DC
Bir parfüm nasıl ortaya çıkar ? Yani bir gün bir koku duyar	da	Tamam bunu yapacağım mı dersiniz ?	DC
6 yıl sonra David James'in uzun pasında Costinha'nın müthiş hatasında , 3. dakikada İngiltere'yi 1 - 0 öne geçirmeyi başardı . Bundan sonra	da	her akınlarında o vardı . Ev sahibini beklemediği bir planla bozmayı amaçlıyorlardı .	NDC
Dışişleri Bakanı Gül ABD’de bu konuda temaslar yapıyor ... Yapıyor	da	: Beyler siz Irak’da yüz binlerce masumu öldürürken hangi yüzle 90 yıl önceki olayın hesabını soruyorsunuz , diyebiliyor mu ?	DC
Ama hemen herkes Türkiye'ye AB üyeliği konusunda açık ve net bir perspektif verilmesini istiyor . Yakın zamanda Türkiye'nin özel kategoride değil	de	, tam anlamıyla aday olması ihtimalini görüyor musunuz ? Tam anlamıyla aday ne anlama gelir ?	NDC
Sana gelirken yolda sürçüp düşenleri , yolunun delisi sadık bendelerin gibi arındırıp mükâfatlandırdın . Şimdiye kadar Sana misafir olmuş	da	ziyafet görmemiş , kapının tokmağına dokunmuş da cevap almamış kimse yoktur .	DC
Güzergahlara yol boyunca resmi polisler belli mesafelerde dizilecek . Yoldaki alt geçitlerin üstü , üst geçitlerin	de	tepesi özel harekat personeli tarafından korunacak . Yol güzergahındaki hakim tepeler ile yüksek binalarda da özel harekatçılar yerlerini alacaklar .	NDC
Hele söyleşi yapıyorsa , inceden inceye araştırır , araştırmalıdır	da	. Not tutma alışkanlığım zaman zaman yerini teybe bırakıyor artık .	DC
Aha abi geliyorlar , hadi gene topal taklidi yap	da	neşelenelim . Bastık kahkahayı ... Yani neticede topal taklidi yapan köpek bile gördü bu gözler ...	DC
Biz Türkler , Yunanlılar'a dönerimize , kahvemize , baklavamıza sahip çıktıkları için de kızarız ama asıl golü meğer sirtakide yemişiz ! Ben yeni öğrendim ama mutlaka bilenler vardır , meğer sirtakinin	de	kökeni İstanbul'a dayanıyormuş !	NDC
Bu konuda kendimi geliştirmeye açığım . Komik olmalıyım , güldürmeliyim ve	de	aşık olmalıyım . Bu filmde kimse ölmüyor ya da kimse korkutulmuyor .	NDC
Bütün bu kuruluşların Erdemir’e talip olması , biraz önce sizin	de	belirtmiş olduğunuz gibi Erdemir’in piyasasıyla yakından ilgili .	NDC
Oruç başıma vurmadan konuyu anlatayım	da	bilgilenin .	DC
Truva filminden sonra Çanakkale ve Çorum'un mezarını paylaşamadığı Aşil'in mızrağının	da	Antalya Phaselis'te olduğu iddia ediliyor ...	NDC
Madem bu adamlar bu kadar örnek alınıyorlar , o zaman onlar da laflarına , yaşam tarzlarına biraz dikkat edecekler . Zaten toplum olarak Aman bir laf etmeyeyim	de	aşıma iş açılmasın . mantığıyla ilerleyen bir milletiz , bunun üstüne bir de futbolculara Konuşma yasağı getiren yöneticiler eklenince tuz biber oluyor .	DC
O kadar uyardık dinlemedin ... Şimdi otur orda soğukta sekiz saat bekle	de	gör şeklinde sitemde bulunulur ...	DC
Bunun dışında bu konudan bir haber durumda olan Fransız parlamenterlerin ya	da	başka ülkelerin politikacılarının popülist kararları sadece ve sadece bu sorunun nihai ve barışa katkılı bir çözümüne zarar verecektir .	NDC
Tarihi yaşamak ve kazanmak Mehmet Ali Aybar'ın Türkiye'de bir sosyalist olarak oluşturduğu model ve ortaya koyduğu çaba belki	de	dünya siyaset tarihinin en ilginç yaklaşımları arasındadır .	NDC
Ekonominin çarkları dönmesine dönüyor	da	, değirmenin suyunun dışarıdan geldiğini bilmek lazım .	DC
Derin devlet deyince hemen MİT’in kastedildiği varsayılıyor , böyle bir şey yok . O derinlerdekinin adı bellidir	de	, ben henüz ecelime susamadım . Akşam Gazetesi’nin önüne karanfil koymaya da gelmez bizim burnu havada enteller , hem Davutpaşa Osmanbey kadar ayakaltı değil , Cihangir barlarından çıkıp kolayca ulaşılamıyor , hem de beni pek sevmezler .	DC
Bunun gibi özelleştirmeye falan da karşı olanlar neden karşı olduklarını söylesinler	de	biz cahiller öğrenelim .	DC
Kaplumbağaları yakalayan bir kartal , hayvanları yüksekten yere atıyor ve kabukları kırılınca yiyiyordu . Aeschylus'un başına düşen kaplumbağayı	da	bu kartal atmıştı . Yayıncı ve 1970'lerde başlayan jogging salgının öncüsü .	DC
Dün Nejat'ı çok gösterdiler . Cambaz'ın siteye girmediği belli oluyor valla , çabucak gir	de	görelim Nejat ' ı . Nihalcim resimler için çok teşekkürler	DC
Sezonun 11. yarışı olan İngiltere Grand Prix'si , İngiltere'nin Silverstone pistinde yapılacak . Bu yarış	da	NTV'den naklen yayınlanacak .	NDC
Fatih hakkında söylediklerim futbolla uğraşanların bildikleri şeylerdi , ancak Altay'a kiralanıp oynadıktan sonra , kulüp erkanı tarafından anlaşılmış olacak ki , kırık bacağına rağmen yüksek ücretle geri alındı . Alındı	da	ne oldu ? Yine patronaj hatasından üstüne yarım milyon dolar da verilerek kendi klasının oldukça altında bir futbolcu ile takas edildi .	DC
hayatim boyunca Hawaii'ye gitmek istedim ama beni deniz tuttuğu icin gemiye binemiyorum , uçaktan	da	çok korkarım . Hawaii'ye gidebilmem için bana buradan oraya bir yol yap .	DC
Nereye çekerseniz çekin Bir de Rusya Büyükelçisi’nin bir sözü var . 9’u yaptınız , 10’u yapın	da	görelim şeklinde . Bunu nasıl değerlendiriyorsunuz ?	DC
zaten karşılaştırma mümkün değil ama arkadaş haset etmiş galiba , birleşip kıyak yapalım	da	üzülmesin . 3600 km yol gittim performansı 2000 motora göre zayıf ama 195'e kadar çok çıktım üstelik çok zevkli sürüşü .	DC
Otogar içerisinde de bir şey bulamadım . Zamanım olmadığı için çarşıya 	da	çıkamadım . Anama Trabzon hediyesi alamadığım için çok üzgündüm .	DC
İhtiyaç bulunmadığını işitmek sevindirici olabilir	de	bu alanda yıllardır çalışan biri olarak bana hiç de böyle görünmediğini söyleyeyim .	DC
İnsanımız , zavallı peynirli çubuğun şarkı söylemesine hayret etmek yerine istedikleri türküyü söylemeyince onu üstüne basarak kırmışlardı . Yaşamda anlam kadar uyum	da	önemlidir . Duvara çakılan sekizlik bir dübel ile ona giren vidanın uyumu , o vidayla onu çeviren tornavidanın uyumundan daha mı az önemlidir ?	NDC
Bizse bu yanık türküleri dinleyip belki de kendimizi vuracağız . Bırakın	da	başarıların sevincini yaşayalım . Panele katılanlar arasında bulunan , 77 kiloda Olimpiyat Şampiyonu Taner Sağır da başarısının hemen ardından taciz olaylarının çıktığını ifade ederek , Doya doya yaşayamadım şampiyonluğumu .	DC
Sektörde zaman zaman yaşanan ekonomik krizlerin	de	etkisiyle Türkiye'de otomotiv ürünlerine olan iç talebin halen istenilen seviyenin altında bulunması , düşük kur nedeniyle sektörün dış ticaret açığı vermeye başlaması , sektördeki tehditleri oluştururken , taşıt araçlarından alınan vergilerin yüksek olması ve küresel firmaların üretimleri karlı olmaktan çıktığında , üretimlerini başka ülkelere kaydırma ihtimali sektörle ilgili diğer tehditleri oluşturuyor .	NDC
Bilgin amaçlarının bankalara müdahale olmadığını da kaydetti . Bilgin BDDK'da çalışan özel temizlik şirketinin bir elemanının kart borcu nedeniyle intihar etmesinin	de	taslak hazırlığında etkili olduğunu vurguladı .	NDC
Neyse sonra skor bizim lehimize dönüyor	da	biraz keyifleniyoruz . Sağımız , solumuz Sienalı taraftarlarla çevrili .	DC
başka bir köşede televizyon izleniyor . 33 yaşındaki İbrahim Aymaz	da	televizyon izlenen uzunca masalara ilişmiş , oturuyor . Aymaz , arkadaşlarının İbo şairdir demesi üzerine utanıyor .	DC
Komşunun sinir olması , büyük bir olasılıkla sesler gerçek mi ? Yoksa , komşular videodan Basic Instict'i 387'nci kez seyrediyorlar	da	, aslında o bağırışlar Sharon Stone'dan mı geliyor ? diye merak ettiğindendir .	DC
Girmez olur mu , dedi , yarın sabah kahvemi hazırla	da	konuşalım . Ben kafeteryaya varıncaya kadar Göksel almış kahveleri .	DC
Tam karımdan ayrılıp üstüne yürümeye davranıyordum ki , Allah'tan def olup gitmeye karar verdi	de	, başımı durup dururken belaya sokmaktan kurtuldum .	DC
Çalışıyorum , hâlâ ameliyatlara giriyorum , merdiven inip çıkıyorum , bu	da	beni ayakta tutmaya yetiyor .	DC
Kenan kızmaz mı? Gece bu saatte karısını eski kocası arıyor	da	. Sarp nedense kendisini eski koca " diye tabir etmekten hem mutlu hem de üzgündü .	DC
Cümlenin ilk yarısını anladım	da	neyi yazayım ? Karşılaşmanın ilk periyodunda bir tek şut atabilen Beşiktaş'ı mı , yoksa oyuncu değişiminin ardından saha ortasında hangi kulvarı kullanacaklarını tartışan futbolcuları mı ?	DC
valla süper olmuş	da	aklıma takılan bir şey var . anladığım kadarıyla fotoğraf makinesini sabitleyip fenerle isminizi karanlığa yazdınız .	DC
Biz destanımızı okuyacağız , Mustafa Kemal’e ! Milletvekili Mustafa Bey , okuyun	da	bir dinleyeyim bakayım dedi . Okuduk dinledi .	DC
İlk yarıda Amokachi Oktay kanat bindirmeleri Ayhan Ertuğrul ikilisiyle de göbekten yaptığı yüklenmelerle gol aradı , buldu	da	. Defans orta saha ve forveti bir blok olarak düşünüp adam kovalamaktan ziyade alan savunması yapan topa basan rakibi bunaltan Beşiktaş F Bahçe'nin etkili isimlerini de iyi kilitledi .	DC
Beşiktaş Başkanı Serdar Bilgili , Fenerbahçe ve Galatasaray’ın	da	desteğini alarak basketbol , voleybol ve hentbol federasyonlarına rest çekti .	NDC
Hani o gün nikah masasında ayağına biraz sert basmıştım	da	, iki hafta alçıyla gezmiştin ya .	DC
Dolayısıyla tarımsal destekle ilgili harcama artışı , bütçenin diğer kalemlerindeki düşüşle zaten kendi kendine telafi edilip bütçenin toplam dengeleri içinde çözülecektir . Bütçenin toplamında	da	, öngörülmeyen ve toplam harcamaları artıracak bir adım atılmamıştır , atılmayacaktır .	DC
Buna göre pokemon , Japoncada Yahudi' anlamına geliyormuş . Bu kelimenin Süryanicede Ben Yahudiyim anlamına geldiği	de	iddia edildi . Ürdün'deki Süryani Ortodoks Kilisesi , o kadar çok tehdit aldı ki , Ürdün ve Batı Şeria'daki gazetelere ilanlar vererek pokemon'la bağlantıları olmadığını açıkladı .	DC
Sonra genç bir çocuk yardım etti	de	, ayağa kalkabildi kadıncağız .	DC
Eğer toplum gençlerine daha sağlıklı sosyal grup kimlikleri sunamıyorsa , o zaman sağlıksız kimlikler ön plana çıkacaktır . Bir toplumdaki marjinal gruplaşmaların hepsini yok etmek	de	normal değildir . Önemli olan sağlıklı olanı yaygınlaştırmak .	NDC
Referandum kararı hâlâ engelleniyor , yasadışı biçimde bekletiliyor . Bu hükümetten her şey beklenirdi	de	Turgut Özal tarzı cingözlükler beklenmezdi , onu da yaptılar sonunda .	DC
Kompozisyon yarışmasına 500 bine yakın öğrencinin katıldığını ve 2 bin 872 kompozisyonun yarıştığını anlatan Akman , 5 , 6 , 7 ve 8. sınıflardan derece alanların yanında 10 öğrenciye	de	teşvik ödülü verilmesinin kararlaştırıldığını kaydetti .	NDC
Etkinliğin önemli gösteri ve göstericileri ünlü Alman sporcu Küng'ten ibaret değildi . Çek Cumhuriyeti'nden , Yunanistan'dan , İran'dan katılan konukların gösterileri	de	şenliğin başarısına atılan önemli imzalardan bir kaçıydı . Genel olarak başarılı bir işleyişle konuklarını ağırlayan şenlik .	DC
Oysa bu revizyon kasım krizinden sonra yapılsaydı , belki	de	şubat krizi yaşanmayacaktı . Dileriz aynı inatla Türkiye'ye yeni bir kriz yaşatılmaz	NDC
tabii ki daha fazlasını hak ediyor	da	bizimkisi şakalaşmak işte .	DC
Şarapların üzümleri arasında Kalecik Karası , Öküzgözü - Boğazkere gibi yerli üzüm çeşitleri de , Cabernet Sauvignon , Merlot gibi yeni yabancı üzümler	de	bulunuyordu . Kısacası , gerek peynirler , gerekse şaraplar ülkemizin olabildiğince geniş ve kaliteli kesitini yansıtıyordu .	NDC
Ayrıca vatansever esnaf ve sanatkarımız yıkıcı değildir . Olamaz	da	. Çünkü biliyoruz ki bu ülke bizimdir .	DC
Şimdilerde çoğu çocuk dört duvar arasında yaşamak durumunda kaldığından , ebeveynler ( özellikle	de	anneler ) vicdan azabıyla kıvranıp duruyorlar .	NDC
Bir pozisyon denedik , yerçekimini kullandık işe yaradı . Doğum koçunun faydası	da	budur . 1.5 - 2 saat sonra bebek doğum yolunda ilerledi .	DC
Hangi koşullarda bu teklif Sibel Tüzün ' e götürülmüş	de	başka kimselere götürülmemiş . Zaten böyle bir şey de yok .	DC
Hele de sıcak yaz günlerindeyseniz , daha bir özenirsiniz Cabrio'sunda saçlarını savuranlara . Biz	de	bu hafta sayfamızda her keseye uygun üstsüz araçları tanıtmaya karar verdik .	NDC
Hrant Dink'in bedeni , hepimizin gözleri önünde , her seçim arifesinde daha	da	heyheyleşen ve ülkenin muktedirlerini , dolayısıyla mukadderatını belirleyen milliyetçi naralar , kurt ulumaları arasında beyaz kağıdın altına gömüldüğüne göre , eline silah alıp Trabzon'dan kalkan ve ilk soluğu İstanbul'da alan katil zanlısını konuşacak değiliz , değil mi ?	NDC
Yazdıklarıma gülüyorsanız , sebebini siz bulun o zaman . Ben 14 yıldır bulamadım	da	.	DC
Yani kendisinin de söylediği gibi , bir yaz albümü değil bu . Tabii müziği , mevsimlerle ilişkilendirmeyenlerdenseniz başka . Yağmur yağmadan	da	rahatlıkla dinleyebilirsiniz . Daha önce Demir Demirkan , Koray Candemir , Öztürk , Aylin Aslım gibi isimlerle çalışan	DC
Yukos davasının son bir yıl içinde Rusya'da tüm kesimler tarafından tartışıldığını belirten Hodorkovski , şunları kaydetti : İnsanlar , bunun normal bir yasal dava ya	da	siyasi amaçlarla açılmış bir dava olup olmadığını tartıştı .	NDC
İçimizden Bugün kendimi Nişantaşı'nda mı yoksa Beyoğlu'nda mı elletsem diye düşünürüz . Hatta bazen Şöyle bir otobüse bineyim	de	arkadan bana sürtsünler deriz . Neyse ...	DC
Hedefi vurmak için attım	da	vuramadım . Tereddüt ediyorsan atmayacaksın , gidip hedefi elinle vuracaksın .	DC
Yenemiyorsan , yenilmeyeceksin . Basit bir kural . Bir puana	da	çok şükür deyip cebine attı . Enerji ve Tabii Kaynaklar Bakanı Zeki Çakan , TEDAŞ’ta ( Türkiye Elektrik Dağıtım AŞ ) emekliliği gelen yaklaşık 4 bin çalışanın emekliye sevk edileceğini söyledi .	DC
Asansör sever misin ? diye sordu . Sevdiğimi söyledim , bindik . Kaçıncı sınıfta olduğumu	da	sordu . Asansördeyken Benimle bodruma geleceksin dedi .	NDC
Yoksa sende de biraz gelişme var mı ? Biraz kendinden bahset	de	insanlar seni de tanısınlar . Sadece fikir yürütüyoruz .	DC
Enflasyon hedeflemesine geçen ülkelerde Türkiye gibi yüksek enflasyonun olmadığını hatırlatan Özatay , bu durumun hem avantaj hem	de	dezavantaj yarattığını söyledi . Eğer uygulanan politikaların kredibilitesi varsa enflasyonun yüzde 65 veya 50 olmasının çok önemi olmadığına işaret eden Özatay , Türkiye'de başarılı maliye politikalarının uygulandığını kaydetti .	NDC
Hadi bütün dokunulmazlıkları kaldıralım , memurun da amirin de , paşanın	da	başbakanın da kaldıralım . Hadi gösterin cesaretinizi diye konuştu .	NDC
Yani niçin iktidar bizim bu önerimizi işi yokuşa sürmeye yönelik veya kötü niyetle veya amacını saptıran bir öneri gibi görür	de	iyi niyetle ele almaz .	DC
Başörtüsü sorunu . Öğrencilerin efendim haklarını sağlayabildiler mi	de	bu profesörlerimiz diğer sorunları nasıl çözecek ?	DC
Hafta başında İsmail Cem pek çoğumuz gibi aslında kendisinin	de	söylemekte çok geciktiği şeyleri nihayet söyledi .	NDC
milli takımlarda bulunan futbolcuların yer almadığı antrenmanda , sakatlığı bulunan Serhat , kulüp doktoru yönetiminde salonda çalıştı . Boyun fıtığının tedavisi için Almanya'da bulunan Steviç	de	antrenmanda yer almadı .	DC
Su satıcıları ve simitçiler de kuyruktaki mudileri yalnız bırakmıyor . Kimi esnafın sahip çıkarak , gün içinde soğuk içecek ikram ettiği İmarzedelere indirimli yemek satışları	da	başladı . Simitle idare ediliyor Ancak kuyruktaki vatandaşlar sıralarını kaybetmemek için karınlarını simitle doyurduklarını , lokantalara ilgi göstermediklerini söyledi .	NDC
Hatta Kedisini yiyen komşusunun köpeğini öldürdü , köpeğin sahibini	de	ağır yaraladı gibi haberlerle bile zaman zaman karşılaşabiliriz ...	DC
bizim kahveyle aynı şey diye cevap veriyor	da	, yeni bir Kardak krizini teğet geçmiş oluyoruz .	DC
Ediz Hun'un gözyaşları makul dakikalar süresince göz pınarlarında toplanıyor , bir müddet sonra	da	aşağıya doğru süzülüyor . O ana kadar fotoğrafları çeken Muhsin Akgün , saygıdan parmağını deklanşöre basmıyor .	NDC
Allah aşkına altın çıkarılacak yer kalmadı	da	Ege mi kaldı sadece .	DC
diğer karede Filistin'de , Ramallah'ta bir geçiş noktasında Türk heyetini kontrol için bekleten İsrailli askerle kolkola görülüyor . Fotoğrafların Aygün'ün izniyle yayımlandığını	da	belirtelim . Korutürk Paris'e gidiyor Türkiye , Irak'ta geçici yönetim işbaşına geldiğinde Bağdat Büyükelçisi'ni değiştirmişti .	NDC
Kemalist sayılan kitaplar yazmış , bunlarla ödül kazanmış biri nasıl olur	da	TBMM’nin hain ilan ettiği bir kişiyi keyfince temize çıkarır sorusu önüme sürüldü .	DC
Benim amacım asla çamur atmak değildi atmadım	da	zaten . Yalnızca Özgürü seven hiç kimse Barışa söz etmedi dikkat edersen .	DC
Köprülü , komisyon raporu ardından Genel Kurul Salonu'nun yenilenmesiyle ilgili iddialar üzerine başkan müşavirliğine getirilirken , Mısırlı önce TBMM Genel Sekreter Yardımcılığı'na atanmış , daha sonra	da	1 Temmuz 1998 itibarıyla emekli olmuştu .	NDC
Bu aralar üst üste birkaç kişiyle bu çok çalışıyorum	da	; başka bir şeye bakamıyorum muhabbetini yaşadım ; konuya o yüzden taktım .	DC
Biz iddialı , büyük bir takımız . Şampiyonlar Ligi'ne girmemiz hedeflerimizi daha da büyütecek ve önümüzü daha	da	açacaktır . Bu nedenle herkesten bu konuda destek bekliyoruz .	NDC
Para kazandırmaz demeye utanıyorum . Sen para kazan	da	felsefeyi ben öğretirim de diyemiyorum .	DC
Tarihimiz , camiamızın tüm bireyleriyle müştereken elde edilmiş başarılarla doludur . Dönemimizde yaşanan şampiyonluk	da	tek vücut olmuş ve şampiyonluğa inanmış , kulübünün menfaatlerini kendi şahsi menfaatlerinden üstün tutan Fenerbahçe ailesi tarafından kazanılmıştır .	NDC
Madem bunlarda yanlışlıklar vardı . O günden bugüne değerlendirilmedi	de	, şimdi neden ortaya çıkarıldı .	DC
Türkiye , Anayasa değişikliğinden çok , Bayındırlık Bakanlığı'ndaki operasyonla ilgileniyor . Bununla	da	ilgilenilmeli tabi ; ama işin özü , hastalığın nedeni , artık yürümediği gün gibi ortaya çıkan mevcut sistemde .	NDC
Yurtdışına çıkışı anlıyorum	da	yurda girişim neden bu gecikme yüzünden engelleniyor .	DC
ben sadece biraz daha güvercin oldugun belli olsun detay görebilmek istedim , minmalizm demek tam sliuet görüntü demektir diye bir şey mi yazıyor	da	ben yorumda yanlışlık yaptım ?	DC
Yalnız elbette matematiği aksiyomatikleştirme çabasında Paeno yalnız değildi , yalnız kalmadı	da	. Onu çok sayıda ünlü matematikçi izledi . Haftaya maceramıza devam edelim .	DC
Ben İstanbul'da master planının yeterli olarak yapıldığına ve yapılacağına inanmıyorum . Çünkü her büyük depremden sonra yasaları çıkarıp sonra	da	yasaların işlemesini sağlayamayan hükümetler maalesef hiç cezalandırılmıyor .	NDC
Yargılama süresince halkın yakın alakasıyla	da	karşılaştım . İlk celsede beraat bekliyordum .	NDC
Tüzmen , Türkiye'nin cari dengesinin 2000 yılında 9.8 milyar dolar açık , 2001'de ise 3.4 milyar dolar fazla verdiğini hatırlatarak , 2002 yılında cari dengenin 1.5 milyar dolar açık verdiğini , 2003'te bunun yüzde 427 artarak 8 milyar dolar , 2004'te yüzde 94.2 artarak 15.6 milyar dolar ve 2005 yılında yüzde 46.4 artarak 22.9 milyar dolara ulaştığını söyledi . Tüzmen , kısa vadeli dış borçların	da	2003 yılında 23 milyar dolar iken , 2004 yılında yüzde 38.2 artışla 31.8 milyar dolara ; 2005 yılı 3. çeyreğinde ise bir önceki yıla göre yüzde 16.2 artarak , 36.9 milyar dolara ulaştığını kaydetti .	NDC
İyi ki oynanıyor . Finalde karşılaşmalarını ben de isterdim	de	, arada biri bir takıma elenip gitseydi bu iki maçtan da mahrum kalacaktık . Keşke final olsaydı . Ben bu maçın 2. tur maçı değil de final maçı olmasını çok isterdim .	DC
Sık sık ya da aşırı şeker tüketimi sonucu kan şekeri yükselmesiyle salgılanması artan insülin , büyüme hormonu yapımını	da	frenler . Büyüme hormonu genel sağlığımız için büyük anlam taşıyan vücudumuzdaki en önemli hormondur .	NDC
Ayrıca aylık hedefler de bulunmaktadır . Maliye bakanın	da	açıkladığı gibi ilk iki ay gerçekleşmesi , beklenenin üzerindedir .	NDC
Ya ilmini bil ya da haddini . Anlayışlı ol	da	ibret al ; gülmesinler , acımasınlar yarın sana !	DC
yerel seçimlerde izlenecek yöntem konusunda durum değerlendirmesi yapıldı . Adayları merkez yoklamasıyla belirleyecek olmasına karşılık AKP , aday sayısının yüksek olması nedeniyle örgütlerin	de	eğiliminin almayı kararlaştırdı . AKP Grup Başkanvekili Faruk Çelik , yerel seçimler için kendilerine yapılan adaylık başvurularının çok yüksek olduğunu kaydetti .	NDC
Ona bakanlar başının üstündeki buz olmuş karı görünce haziran sıcağında bile üşüdü	de	o gene kendinden geçmeye razı olmadı .	DC
Güneşten koruyucular güneşe çıkmadan en az yarım saat önce ve parmak uçları ile uygulanmalıdır . Böylece koruyucu vücut ısısına ulaşıp vücudun binlerce küçük kıvrımını doldurur ve etkin koruma sağlar . Kulaklara , burna , dudaklara ve göz etrafına	da	uygulama unutulmamalıdır . Yüksek yerlerde ve düşük enlemlerde ekstra koruma kullanın .	DC
yapacaksan bu doğrultuda bir girişim yap	da	seni alkışlayalım . Yoksa ABD Irak’ta nasıl boğulacaksa , senin iktidarın da aynı akıbetten nasibini alacaktır .	DC
Ne gibi Ömer amca ? Ara sıra gel	de	bana islamiyeti anlat ! sen çok güzel şeylerden bahsediyorsun .	DC
Akaretler'deki kulüp binasında gerçekleştirilen toplantıda , yönetim kurulu üyeliğinden istifa eden Koray Büyükasar'ın yerine Kenan Öner'in atanması kararlaştırıldı . Yapılan görev bölümünde	de	ikinci başkanlığa Murat Aksu , genel sekreterliğe Kenan Öner , futbol şubesinden sorumlu asbaşkanlığa Kıvanç Oktay , saymanlığa Can Akın Çağlar , kulüp ve basın sözcülüğüne de Reha Muhtar getirildi .	NDC
Benimle gurur duyuyor oğlum . Şimdi büyüdü	de	bana o bakıyor . Bundan sonra erotik filmlerde de oynamayacağım .	DC
Bahçeli , partisinin dünkü grup toplantısında , Meclis'in beş partiden oluşan siyasi kompozisyonu ve bu kompozisyonun iktidarla muhalefet arasındaki dağılımının , uzlaşma ve işbirliğini ön plana çıkardığını söyledi . İktidar ortağı partilerin yanında muhalefet partilerinin	de	benzer bir yaklaşım içinde olduğunun görüldüğünü kaydeden Bahçeli	NDC
AB'nin affedilmez bir şekilde ihmal ettiği ve tartışılması gereken risk ise , zayıflık ve büyüklük mirasıdır . Türkiye ve onunla birlikte ya	da	ondan sonra kaçınılmaz olarak üye olacak Ukrayna , AB'yi siyasi ve ekonomik açıdan çöküntüye kadar sürükleyebileceklerdir .	NDC
Eş , dost kapitalizmini biliyordum	da	, günün birinde eş dost hukukunun hortlatılmak isteneceğini aklıma getirmemiştim .	DC
Bu yürüyüş sonrası Emniyet Müdürü Abanoz , aralarında şube müdürlerinin	de	bulunduğu çok sayıda polisin tayini için bir liste hazırladı . Ancak Vali Çakır , tayin listesini geri çevirdi .	NDC
Birbiri arkasından gelen Galatasaray yönetimleri başarıyı da , başarısızlığı	da	yönetemediler ne yazık ki ... Başarı , 2000'de zirveye çıktı .	NDC
Gerçekten de , her şeye rağmen üstüne gidilecekse , birtakım arızalar ve kazaların değil , bir sistemin ve sistemli ilişkilerin söz konusu olduğunu göreceğiz ... Aslında görüyor ve biliyoruz	da	... Adını tam koyacağız ...	NDC
Ayrıca kim eleştiri yaptı	da	dışlandı şimdiye kadar  ?	DC
Masalda tilki yalandan kargaya çok güzelsin deyip duruyor ya , gelsin	de	bu kargayı görsün . En iyisi ben bu fotoğrafı oğluma göstermeyeyim	DC
DPT , Konya'ya un fabrikası öneriyor Yabancı sermaye için yatırım ortamının iyileştirilmesinden söz ediyoruz	da	, yerli sermaye için ortam cazip mi ? Türkiye Odalar ve Borsalar Birliği ( TOBB ) Başkanı Rifat Hisarcıklıoğlu anlattı .	DC
Üstüne çıkmak da istemem , altında kalmak	da	istemem. Orada hep okşama ilişkisiyle yaşamak isterim .	DC
Çolpan abla da oyunun provalarını erteledi , Sen filmini bitir	de	gel , ocakta başlarız dedi .	DC
Sayın Baydur parti liderlerini ziyaret edip eğer İş Güvencesi Yasası çıkarsa 300 - 500 bin kişi işten atılır söylemini dile getirdiğinde tehdit ediyor olmuyor	da	; Türk - İş Hak - İş ve DİSK konfederasyonlarının genel başkanları aynı parti liderlerini ziyaretlerinde İş Güvencesi'nin çıkması yolundaki dileklerini ortaya koyduklarında acaba nasıl tehdit ediyor tanımlamasını yapıyor , bunu anlayabilmiş değilim .	DC
Yoksa her maç böyle oluyor da biz mi görmüyoruz televizyonlardan ? Biz görmüyoruz	da	da , bizim polisimiz , taraftar diye nitelendirdiğimiz güruha sempati duymuyor nedense .	DC
Bilmiyor musun işine mi gelmiyor	da	çarpıtıyorsun . Oku !	DC
İlk defa sıfır atıp yeni para birimine geçiyordu , çevre ülkelerdeki kötü örneklerin izlerini bastırmak gerekiyordu . Bu yüzden	de	tanıtımın etkili olması amacıyla aylar öncesinden kampanya başlatıldı . Operasyon öncesinde 15 ayrı , sonrasında da yedi ayrı tanıtım filmi televizyonlarda yayımlandı .	NDC
Bu arada son 10 yıl içinde düşük dereceli devlet memurlarının yanı sıra başta öğretmenler ve güvenlik mensupları olmak üzere bazı grupların maaşlarında yapılan ek iyileştirmeler , dolar bazında yapılan maaş hesaplamalarında	da	kendisini gösterdi . 1989 yılı Ocak ayında işe yeni başlamış ilkokul mezunu bir devlet memuru , bir aylık maaşıyla 74.7 dolar alabiliyordu .	NDC
Bu konuyu çözümlemek istedi , formül buldu	da	, CHP , hayır mı dedi .	DC
Tabii Allah'tan konuklar arasında Sibel Tüzün vardı yoksa bu yazı Ünlülerin verdikleri ilginç cevaplar olarak değişecekti . Tüzün doğru cevapları buldu	da	rahat ettik . Uzun lafın kısası bir daha 31 Aralık'ta televizyon seyredilmeyecek .	DC
Ticari ayağı ağır basan ilişkiler , Çad'daki Kanem Bornu İmparatorluğu ile Osmanlı İmparatorluğu arasında Sultan 3. Murat döneminde imzalanan savunma paktı sayesinde askeri boyuta	da	taşındı . Çad'la ilişkiler , Fransa'nın kolonisi altına girdiği 20. yüzyılda ise koptu .	NDC
Tabi olmamak elimde olsa olmam , affı	da	reddederim . Suçlu , Türkiye'yi bu duruma düşürenlerdir .	DC
Yüce Türk Milletini küçük düşürmek için bazı haddini bilmez yabancı çevrelerce alay konusu yapılmakta olan kıyafet biçimlerini	de	yeniden düzenlemiştir . Bu düzenlemeler ile Türkiye Cumhuriyetinin uluslararası ve üst düzey protokolde resmî merasim kıyafetinin beyaz kelebek kravat ve siyah yelek üzerine giyilen fraktan oluşan salon kıyafeti olduğu esası getirilmiştir .	NDC
GSM işletmecileri sınır bölgelerinde , bir kısmı Silahlı Kuvvetlere ya	da	Orman Bakanlığı'na ait olması , bir kısmı da SİT alanı olması nedeniyle baz istasyonu kuramadı .	NDC
forumlarda kimsenin işi gücü kalmadı	da	seninle uğraşacak .	DC
İzel bomba ama ercan çok ayrı , hem euruvision da lazım izeli bilmem	de	, bence ercan saatçi temsil etsin bizi , hem Avrupa' ya daha şirin görünürüz .	DC
Herhalde DGM Savcılığı ya da Adalet Bakanlığı tarafından kamuoyunun merak ettiği soruları cevaplandıracak şekilde bir açıklama yapılır . İlk gün	de	söylediğim gibi ilk görünüş itibariyle adli bir olay görünümü verdiğini söylemiştim .	NDC
Çünkü maç günlerinde en kalabalık kafelerin başında yer alıyor . Her iki katında	da	projeksiyondan maç izlemek mümkün .	NDC
Eczacılara güvenerek bu ürünlerden alıyor olabilirsiniz ama yine	de	yanlış bir tercih yapmak istemiyorsanız , bu yazı tam size göre .	NDC
Bana her gün gel	de	, Türkçe sohbet edelim .	DC
70 milyon demişsin şimdi 75 milyon olduk . Sana soran olmamış . hadi ben sorayım	da	sevin . Nüfusumuz ne kadar olsun ? KM kareye kaç kişi düşerse yeter .	DC
sözleri çok iyiydi bana göre ve çınarı dün gece daha iyi anladım gururun ne demek olduğunu	da	çınar mavinin resimlerini hani aylardır baş ucunda duran resimleri çekmeceye kaldırdı ya ben kendimi çok acayip hissettim sanki yenilmiş gibi ...	NDC
O kadar iyi biliyorsan çık	da	sen at bakalım o golleri .	DC
Arkadaşlar ben geldim	de	hiç hoş gelmedim .	DC
Dedim ki bütün aileyi bu yıl başında toparla . Ben	de	geliyorum . Babam telefonu kapatmış ve öyle mutluyum ki demiş .	DC
SL100 , kullanıcılarına ikinci bir el cihazı yardımıyla telsiz tarzı iletişim imkanı sunuyor . SL100'ü bebek telsizi ( babyphone ) olarak	da	kullanmak mümkün .	DC
Hayatımızın hatası lütfen okuyun herkes okusun	da	bilsin . Hatamız 307 look almak oldu .	DC
bankalarının milli sermaye elinde kalması için uğraşıyorlar . Onlar bu işi bilmiyor	da	yalnızca biz mi biliyoruz ! Sevgili dostlar , bu noktada konuyu biraz daha açalım	DC
Daha sonra , Kadir Çelik'in programında iki kere Yaşar Öz'ün o dosyayı açıkladı , beni çıkarttı , Mesut Beyi çıkarttı , hatta teslim alan komiseri	de	çıkarttı , kamuoyu ilgi duymadı .	DC
Yoksa Orhan'la Kerem birbirini öldürecek dedi . Ben	de	ödemeyeceğimi ifade ettim . Akın , kendisini Yeşil' olarak tanıtan kişinin kendisine Oturduğun sitenin güvenlik şefinden senin çevreye çok yardım ettiğini öğrendim şeklinde konuşarak , üstü örtülü şekilde göz dağı verdiğini ifade etti .	NDC
Yukarıdan hasta diye indirilen çocuğa niye coplarla saldırdı Türk Polisi ? Yoksa her maç böyle oluyor	da	biz mi görmüyoruz televizyonlardan ?	DC
Neyse ki yaşananların ve yaşatılanların utancı basınımızda bazı vicdanları rahatsız etti	de	, İsviçre-Türkiye maçı esnasında zirveye çıkan cinnet ardından bazı gerçekleri görenler var .	DC
Türkiye'nin , işkencenin ve yasal olmayan tutuklamaların tamamıyla yok edilmesi , yargı sisteminde şeffaflık özellikle	de	yeni yasaların yürümesi konusunda yargıda reform , yaşam standardının yükseltilmesi , terörizmle mücadele , göçle ilgili konular , serbest ekonomi , yabancı yatırımları cezbetme , ifade özgürlüğü gibi iç sorunların yanı sıra Kıbrıs sorunu gibi dış sorunları da çözmek zorunda olduğuna işaret edilen haberde , bu isteklerin AB'nin standart koşulları arasında yer aldığı , bunların arasında önemli olan ve İngiltere'nin üzerinde durduğu , Türk kimliğinin köklerinde var olan ve 1300 yıldan beri bu ülkenin kültürel temelini oluşturan konuların değişmesi olduğu vurgulanmaktadır .	NDC
Yani yıllara yaymamız lazım . Yıllara yayabilmenin tek yolu	da	IMF'den geçiyor . Kendimizi zorlayarak ( 2 - 3 sene içinde borçlarımızı ödeyeceğiz ) demek yerine 25 milyar doları daha rahat ödeyebilmek için IMF ile yeni bir düzenleme yapmak lazım .	DC
Oral , memur maaşlarında enflasyonun üzerinde 2 puanlık refah payı uygulamasının sürüp sürmeyeceğine ilişkin soruyu da Katsayı tespit edilirken ona	da	karar verilecek . Biz katsayıyı tespit etmediğimiz için buna da yer vermedik diye yanıtladı .	NDC
Ne yani , Abi ben hırsızım , biraz koltuk çık	da	dükkân açalım , diye kapıda kuyruğa mı girecek vatandaş ?	DC
İkinci turda her gruptan birinciler final - foura kalacak . İçerdeki maçları kazanıp , deplasmanda	da	galibiyetler alarak , final foura kalmak istiyoruz .	DC
Acaba Amerikalı dostlarımızın Irak'a bir askeri harekat niyeti yok	da	bu harekat olasılığını sürekli ayakta tutup Irak yönetimini , Bağdat yönetimini canından bezdirmek mi istiyor bu akla gelen bir şey .	DC
Bundan sonra biz de çapulcu gibi davranalım	da	gör bakalım çapulcu nasıl oluyormuş .	DC
siz bir ilacı uzun süre kontrolsüz verirseniz , istenmeyen sonuçlarla karşılaşırsınız . Şişmanlık ilaçlarında da şişmanlığı önleyici tedavi protokollerinde	de	yapılan en büyük yanlışlar , bir takım yanlış medyatik yaklaşımlarla ilaç olduğu bilinmeyen bazı maddelerin de kontrolsüz olarak kullanılması .	NDC
GM Başkan Yardımcısı Jonathan Browning , Türkiye'de yatırım planlarına ilişkin bir soruyu , Burada geçmişte montaj tesisimiz vardı . İmalat	da	yapıyorduk . İmalat açısından Türkiye gelecekte çok çekici bir lokasyon olacak .	DC
Helikopterle kurtarma Gerektiğinde helikopterle de kurtarma olabileceğini ifade eden İstanbul Büyükşehir Belediye Başkanı Topbaş , üç gündür kanal ve mazgal temizleme çalışmalarının sürdüğünü , kritik noktalarda	da	iş makineleri ve kurtarma ekiplerinin hazır olduğunu bildirdi .	NDC
Bunlar nedir yahu , ben mi uzaydan geldim	de	anlamıyorum yoksa bunlar mı uzaylı  ?	DC
Bu kültür M.Ö. II . binde özellikle Ege Bölgesi ve Boğazlar yoluyla Karadeniz’le , Balkanlar yoluyla Avrupa’yla , Anadolu yoluyla	da	Ön Asya ile ilişkideydi . Girit’in diğer kültürlerle ilişkisi ticari amaçlıydı .	NDC
Deri iyice cızır cızır olmalı ki derideki yağlar ete insin . Ters çevirince	de	diğer tarafa geçsin .	NDC
İnanır mısınız , onun hatasını , o bizden para çaldığını Mehmet Bey duydu	da	bana söyledi . Bu adam para çalıyor , haberin olsun , kovar mısın , atar mısın bilmiyorum dedi	DC
Şarkı bitmiş bara geçiyorsunuz , insanlar geliyorlar , içeyim bari kurtulayım dediğim günler onlar . Şimdi içmiyorum , barda	da	çalmıyorum . Şimdi nasılsınız ? Şimdi daha çok yalnız kalmayı sevmeye başladım .	DC
1982 ile 1995 arasında 420 bin kişi incelenerek yapılan araştırma , konusunda dünyanın en kapsamlı araştırması oldu . Bilimadamları , bu yıllar arasında , vatandaşlık numaralarını kullanarak , aralarında 10 yıl süre cep telefonu	da	kullanan 50 bin kişinin de bulunduğu 420 bin kişinin sağlık kayıtlarını inceledi .	NDC
Bu kez ; sağ elin diğer parmakları akım yönünde kıvrıldığında , başparmak alan yönünü gösterir . Atomların yörünge elektronları	da	, hareketlilikleri sonucu , dairesel akım oluşturuyor gibidirler . Dolayısıyla bazı atomlar , minik mıknatıslar gibi davranır .	NDC
Hıristiyan - Demokratlar böylece Günther Verheugen'in raporunu meşruiyet tartışması zeminine çekmeye çalışacaklar . Gerçekten	de	Komisyon görevi devretmek için gün sayıyor .	NDC
Bunun üzerine mahkeme Akkuş'un cinayetle ilgisi olmadığı için tahliyesine , davanın	da	yeniden görülmesine karar verdi . İkinci yargılamada Akkuş beraat etti ve karar kesinleşti .	NDC
İhale peşinde değiliz , bu işten anlamayız , komisyonculuk	da	işimiz değil . Sadece yanlış gördüğümüz şeylerin yanlış olduğunu göstermeye çalışıyor ve bazı günahlara ortak olmak istemiyoruz .	DC
Neden darbeler hep üçüncü dünya ülkelerinde , G. Amerika'da ya	da	okyanusların muz cumhuriyetlerinde gerçekleşiyor ? Birkaç gün önce Pakistan'da ihtilal ...	NDC
Sinemanın en önemli işlevlerinden biri zaten kültürleri irdelemek ve buluşturmaktır . Dünya'da yaşanan olayları	da	göz önüne aldığımızda , farklı kültürleri Antalya'daki bu organizasyonda buluşturmayı hedefledik dedi .	NDC
yapı malzemesi olarak meşe , gürgen ve çam ağaçları kullanılan evlerin en önemli özelliği , sokak ya	da	ön cephe yönünde , doğal bitkisel çizgilerin yanı sıra çiçek ve hayvan figürlerine ağırlık veren art nouveau ve barok sanatlarını yansıtması .	NDC
Kapıdaki güvenlik görevlisi beni oyalamaya çalışıyor ; 10 dakika kadar başarılı	da	oluyor . Ama ben sabahın köründe gazeteye gitmeye alışmışım ya , içimde hep işe geç kaldığım hissi var .	DC
Ne olursun anneciğim babama söyle	de	doktor amcalar ellerimi geri taksınlar .	DC
Onun etkilerini tasarrufçu özümsedi ve zaten garanti kalkmayacak , 50 milyara inecek . Bu	da	ülkemizdeki ortalama mevduatı fazlasıyla karşılıyor . Geniş kitleleri fazla etkilemez .	DC
Eskişehirspor'un ikinci yarısına çıkmadığı maçta hiçbir şey mi olmadı	da	bu kadar kızmaktasınız Allah aşkına ?	DC
günde 5 saat çalıştı	da	o reklamdaki gibi vücuda sahip oldu .	DC
Ecevit , Silahlı Kuvvetler mensupları , polis , vali ve kaymakamların bu bölgelerde zorunlu olarak görev yaptığını hatırlatarak , aynı zorunluluğun başka meslek dallarına da getirilmesinin yararlı olacağını , doğu ve güneydoğuda buna büyük ihtiyaç olduğunu söyledi . İl özel idarelerinin bir görevinin	de	kırsal alanın ve köylülerin kalkınmasına katkıda bulunmak olduğunu belirten Ecevit , valilerin de bu konuda büyük çaba gösterdiklerini kaydetti .	NDC
Zaten toplum olarak Aman bir laf etmeyeyim	de	başıma iş açılmasın mantığıyla ilerleyen bir milletiz , bunun üstüne bir de futbolculara Konuşma yasağı getiren yöneticiler eklenince tuz biber oluyor .	DC
daha erken takip etmeye çalışayım	da	bu kadar birikmesin sayfalar .	DC
Ya ona bir şey olsaydı . Gözlerinin önüne gelmiş	de	kovmak ister gibi yüzünü buruşturdu Nehir .	DC
Ben gazete okumuyorum , ömür boyu	da	okumayacağım . Bana güzel bir gerçekten bahsedin , düşleri bir kenara bırakayım .	DC
Bir seferinde Özaslan’la koridorda karşılaştık : Kız buralara gidip geliyorsun	da	neden bana uğramıyorsun . Gel bak bu yeni binada çok modern olduk .	DC
Karamsar tipteki kadınlar , problemlerini genellikle arkadaşlarıyla paylaşır ve o anda söylenenlerle , verilen destek	de	ikna olmaları için yeterli olur . Fakat eve dönüp , yalnız kaldıklarında kendilerini yine televizyonun karşısında kara kara düşünürken bulurlar .	NDC
Tamam çarpık kafalı olduğumu anladım	da	bu nasıl oluyor da Türkiye ' nin haklılığının göstergesi oluyor onu inanın anlayamadım .	DC
Olduğumuz gibi görünelim de şeffaf olalım , yani bakınca kimse bir şey görmesin , diye mi ? Yoksa , olmadığımız gibi bir imaj yaratalım	da	arkasına saklanıp kafamızı dinleyelim , diye mi ? Ne olursa olsun , işin tadını belirleyen , dürüstlüktür .	DC
Türkiye’yi desteklemek için , imza kampanyaları , toplantılar , gösteriler	de	yapıldı . Kişisel çaba gösteren Türkler de var .	NDC
Böylece daha önce Ecevit hükümeti zamanında da tartışılan ekmeğin poşetlenerek satılması kesinleşti . Ekmek	de	diğer tüm gıda maddeleri gibi poşette satılacak .	DC
Tahran'da halka hitap eden Ahmedinecad , Filistinliler ve bölgedeki öteki ulusların eninde sonunda İsrail'i bölgeden söküp atacaklarını iddia ederken Yahudi soykırımının peri masalı olduğu yolundaki iddiasını	da	tekrarladı . Daha önce İsrail'in haritadan silinmesi gerektiğini savunan ve Batı'ya alın kendi topraklarınızı verin diye seslenen Ahmedinecad , son konuşmasında yine Batı'ya çağrı yaptı ve 60 yıl önce yarattığınızı ortadan kaldırın .	NDC
Tükete tükete hikâye kalmadı	da	, onun için mi böyle bir yarışma düşündünüz  ?	DC
Kitap ucuz olsa , insanlar özeniyor	da	okuyor deriz . Bu kitabı daha çok 25 - 40 yaş aralığındaki kadınlar alıyor .	DC
Erkek , kadının üzerine evlenebilir . Dilerse karısının , karılarının üzerine cariye	de	alabilir . Kadın için , kocasının üstüne evlenmek gibi bir hak yoktur .	DC
kavga ettik diye açıklama yaptı	da	oradan biliyorum detayları .	DC
Adana ' dan çıkılan yol , şimdilik Milano ' dan geçiyor	da	Hoca ' nın aklından uzun vadede neler geçiyor çok merak ediyorum .	DC
Allahım nolur , nolur şu maviye akıl fikir ver	de	iyi bir şeyler olsun . Dediğim gibi Aksak mavinin çınara karşı olan hislerini duyacak .	DC
İyi niyet olmazsa , samimiyet olmazsa , diyalog bir fayda getirmeyecektir . Bu konuları dile getirdik ve hemfikir olduğumuz her iki taraftan	da	vurgulandı . Yılmaz , bugünkü dünyada Hıristiyan ülkelerde Müslüman nüfusun , Müslüman ülkelerde	NDC
Üçüncüsü , hükümetin beklentileri iyi yönetemediği ortaya çıkmıştır . Piyasalarda gelişen , ABD mali paketi ile ortaya çıkabilecek olumlu tablo beklentisi , hükümet tarafından	da	desteklenmiştir . Para gelmeden girilen balayı havasına Durun bakalım denilmemiştir .	NDC
maç başına ortalamalarına bakıldığında Galatasaray'ın üstünlüğü maalesef kendini en çok sarı ve kırmızı kartlarda gösterdiği görülüyor . Her ikisinde	de	birinciliği kimseye bırakmamışlar . Sarı kırmızılı futbolcuların Türkiye'deki maçlardan sonra Biz Türkiye'yi Avrupa'da temsil ediyoruz	NDC
Ardından eve gidelim diye önerdi küçük arkadaşım . Eve gidelim	de	televizyon seyredelim . Kumandayı kaptırmadım ama klip seyretmesine engel olamadım .	DC
Hatta geçen yıllarda Çin'den gelen bir şilep dolusu kalitesiz de olsa işe yarar durumdaki televizyonlar , binlerce ailenin evini renklendirmişti . Televizon dedim	de	, aslında Küba'da sadece iki adet devlet kanalı var .	DC
Gazete yolda ... Radyo ve TV için çalışmalar yapılıyor . Çok güzel	de	, bu iş Türkiye Spor Yazarları Derneği’nin takım kurup Süper Lig şampiyonu olmasına benziyor .	DC
sen hala korkuyorsun demek o zaman bekle	de	gör cesareti dedi don kişot ; ve keşişlere saldırdı	DC
3.5 saatlik operasyon geçiren Gürüz'ün parmağının diğer bölümünden doku ve deri alınıp kopan parmak ucuna yamandı . Tırnak kökü	de	yerine dikildi . Tazminat istedi İki ay boyunca sağ elini kullanamayan Prof. Dr. Gürüz .	DC
Pazartesi günkü yazımızda , BRT'de Türkçe konusu tartışılırken Yalçın Menteş'in söylediği tekerlemenin eksik olduğunu belirtmiş ve kendimize göre tamam olanı yazmıştık ... Meğer bizim bildiğimiz	de	eksikmiş ! Başta tiyatro oyuncusu Savaş Dinçel dostumuz ve diğer okurlarımız eksiğimizi tamamladılar .	DC
İşte orada şüpheliyim . Yani normalde insanlar öyle söyler	de	iş icraata gelince mırın kırın eder .	DC
Şimdi ekonomiden kendisinin de sokaktaki vatandaşın da köylünün ve memurun da rahatsız olduğunu dile getiren Zorlu , Ama geriye dönelim	de	arkamıza bakalım nasıl bir hayat yaşadık , nasıl bir harcama yaptık ?	DC
Batılı dostlarımız için Kıbrıs sorunu galiba uygarlıklar çatışması niteliği kazanmış	da	bizim haberimiz yok . Uyanmadıysak bile tek gözümüzü açabiliriz .	DC
Başbakan Recep Tayyip Erdoğan , yapılan zammın Sirke gitmek en büyük merakım , en büyük heyecanımdı , çocukluğumdan beri . Şehre bir sirk gelsin	de	ben gitmeyeyim . Ben hâlâ çocuğum , ama BAŞBAKAN Erdoğan Muhafazakarlık ve Demokrasi semponyumunda çok önemli bir konuşma yaptı .	DC
O suretle gömülecek olanı ihya etti	de	gömülmez oldular . Diye onunla iftihar etmiştir .	DC
Millet geçmiş seçimlerde dediklerimize uymadı , Ya rabbi , ben belamı istiyorum diye oylarını diğer partilere verdi . Allah	da	belalarını verdi . SP nurtopu gibi yeni bir çocuk olarak doğdu .	NDC
Amerikalı yetkililer her ne kadar Irak'ta iç savaş olmadığını iddia etse de saldırılar bunun tersini gösteriyordu . Artık sözler	de	tersini gösteriyor ... Guardian gazetesinin muhabiri , Irak'taki direnişçi gruplarla konuştu .	NDC
bu arada daha önceki vukuatını da hatırlatalım , uzatmalısı Derya Tuna’yı daha	da	ileri gitmis ve ayağından vurdurmuştu , Asena’nın da benzer bir akıbete uğramış olduğunu öğrendim daha sonra da .	NDC
Moskova davalarına benzer , diktatoryal dönemlerin getirdiği yargıların zaman içinde aşılması daha kolaydır	da	, tarihin gelişme yönünde yer almayanların sonradan bağışlanması daha zordur .	DC
İş için , yalnız başıma geldiğim seferlerde adabımla gelip , toplantılarımı yapıp yine adabımla gidiyorum	da	, bütün o en sevdiklerimi görüp derinlere dalınca dönemiyorum bir türlü .	DC
Yaşamın bir anlık kayda geçirilmesini onlara borçluyuz . Evin , evlerin yalnızlıkları da sevinçleri	de	onlara ait . Son söz Necatigil'in .	NDC
Bahçeli , kararlılık ( ! ) gösteriyor , Ben bir siyasi partiyim diyor . İyi güzel	de	gelin bir de şöyle bakalım . İdam konusunda Muhalefetle anlaşabilirsiniz diyen MHP ve Bahçeli , ne oldu da sonradan ortaya bir de kültürel haklar konusunu çıkardı ?	DC
Bu bölgelerde üretim yapan firmalar ömür boyu gümrük vergisi	de	dahil olmak üzere tüm vergilerden ve ihracat / ithalatla ilgili tüm düzenlemelerden muaf .	NDC
Danıştay 5. Dairesi , Kayahan'ı haklı buldu ve önce yürütmeyi durdurdu , ardından 1979'da belediye işlemini iptal etti . Kayahan geriye dönük olarak maaşlarını	da	alabilecekti . Bu kesin karara rağmen belediye Kayahan'a işbaşı yaptırmadı .	NDC
Birkaç kez çok zorlandığımız noktalar oldu . Hatta hiç geri adım atamayacağımız bir nokta	da	çıktı . Umudumuzu kaybettiğimiz bir nokta .	DC
Çayı sütlü içmenin vahim bir saçmalık olduğunu düşünmelerine rağmen , mademki bu salak kul da böyle bir huy edinmiş deyip , her seferinde de bana özel minnacık kapta süt koymayı	da	ihmal etmiyorlar tepsiye . Kimileri kıtlama içer , kimileri limonlu kimileri sütle işte ...	NDC
Şaşılık ameliyatı genellikle genel anestezi altında yapılır . Bazı erişkinlerde lokal anestezi	de	uygun olabilir . Ameliyat sadece göz küresini saran dokunun kaldırılması ve gözü hareket ettiren kaslara ulaşılması ile başlar .	DC
Hatiboğlu , daha sonra yaptığı açıklamada , yasanın iptalini istedikleri hükümlerin , Anayasa'nın başlangıç maddesi	de	dahil olmak üzere bir çok maddesine aykırı olduğunu söyledi .	NDC
O zaman niye yorumluyorsun kardeşim , diyecek olursanız , olayı anlatayım	da	öyle karar verin ...	DC
Sana boşuna delifişek demiyoruz , Biliyoruz	da	konuşuyoruz . Sen hiç rol yapamıyorsun ya , neyse işkolik hanım ben gidiyim artık , yoksa açlıktan ölücem .	DC
çocuklara daha iyi gelecekti , gelmeyecekti	de	gelseydi keşke , olsaydı , ne iyi olurduydu .	DC
Güvenlik durumunu kontrol edebileceğimizi düşünüyoruz derken Bremer , Egemenlik devrine hazır olduğunuzu söylediniz , biz	de	kabul ettik . Irak'ın geleceğinden emin olarak bu ülkeden ayrılıyorum ifadesini kullandı .	DC
AB üyeliği işte şu önümüzdeki reform önlemlerinden geçer . Yok başka yerden geçer diyorsan , üye yap	da	nereden geçirirsen geçir . DEMİREL'in konuşmasının başında	DC
Bu paketi kurduktan sonra Media Player Classic ve KMPlayer gibi oynatıcılar ile en iyi performansı alabilirsiniz . Tabii program diğer oynatıcıları	da	destekliyor . İçeriğindeki çözücülere ve araçlara bakarsanız gerçekten işe yarayacağını siz de göreceksiniz .	DC
Onu , yazıda adı geçen diğer isimlerle bir tutmam . İlişki fiskoslarıyla manşet olma derdi olduğunu	da	hakikaten sanmam . Ama söyler misiniz , şovbiz nüfusu , bir lokma daha reytingden , bir parça daha gündem olmaktan şikâyet edebilir mi ?	DC
Nasıl endüstriyel bir yatırımda vergi muafiyetleri tanıyorsanız aynı şekilde kültürel faliyetlerde bulunan kurumlarda	da	benzer vergi muafiyetlerinin tanınması lazım .	NDC
yarın sınavım var ama şurdan da kalkmak hiç gelmiyor içimden . neyse biraz çalışayım	da	tekrar gelirim bol bol yazın arkadaşlar Begüm'ün de dediği gibi .	DC
Paylaşınca çoğalacağımızı düşündüğümüzden mi ? Olduğumuz gibi görünelim	de	şeffaf olalım , yani bakınca kimse bir şey görmesin , diye mi ? Yoksa , olmadığımız gibi bir imaj yaratalım da arkasına saklanıp kafamızı dinleyelim , diye mi ?	DC
İlk söylediğimiz noktaya geri dönmek istiyorum . Bu seçim sonrasında	da	herkesin kendini yeniden tanzim etmek zorunda kalacağı bir yeniden derlenip toparlanma seçimine gebe kalacak gibi .	NDC
Buna dayalı olarak da eğer bina bazında önlemini alamamışsa ki halkın tabi herkesin alma şansı yok , yedekleme sistemleri yoksa su kesintisi ve doğalgaz kesintileri gündeme gelmeye başlıyor ve o zaman	da	malesef kent yaşamı modern yaşam bu tür koşullardan dah açok etkileniyor , böyle söylemek lazım .	NDC
Harun yerde kurbanın kan izinden farklı muhtemelen katile ait olan ve bacağından akan kan damlaları buldu . Kan damlalarını takip eden dedektifler cinayet silahı gibi görünen nesneyi	de	buldular ; 10 cm uzunluğunda tek tarafı keskin bir bıçak .	DC
Müddeiumumî yerine savcı'yı benimsedik	de	, hâkim varken yargıç'a kanımız kaynamadı işte .	DC
Sen kendi haremine sahip çık . Bizi de , bırak	da	kendi haremimizde demokrasi , düşünce özgürlüğü , inanç özgürlüğü gereği içerisinde bunu yapalım .	DC
katil yakalanacak film bitecek sandık oysa dedektifler resmen katilin elinde oyuncak olmuş	da	haberimiz yokmuş . hele dedektif Mills'e karısının kesik kafasını gönderdiği sahnede aklımdan çıkmıyor .	DC
Biz sohbet ederken Meclis Başkanı Bülent Arınç geldi ama kameriyenin altına girmedi	de	girişinde beklemeyi tercih etti .	DC
Buna kafası yatmayanlar da , Niçin böyledir	de	daha iyisi yoktur diye düşünebilirler .	DC
Genç kız uykuya daldığında arkadaşı da alt katta ki yaşlı ressama ziyarete gitti . Bu sırada yaprak olayını	da	anlattı yaşlı adama .	DC
Seri gol fırsatları yakaladık . Riske	de	girdik . Ancak sadece bir gol bulabildik .	DC
Veya küfürbaz , polis tarafından kulağından tutularak tribünden atılır . E , zoraki ayıklamanın sonucu olarak	da	nesilleri yavaş yavaş tükenir . Nasıl yani , binlerce kişiyi kontrol edebilecek miyiz ?	NDC
Aslında zeytinyağında bir meyve kokusunun olması gerektiğini Hasan bey bize anlattı . Ancak koklarken ve tadarken gerçekten	de	o kokuyu ve tadı duyumsuyorsunuz . Tabii ben , acemi bir zeytinyağı tadımcısı olarak .	NDC
Allah'tan , sizi temsilen birkaç aydın müsveddesini hapishanelerde tutuyorum	da	, içim biraz olsun ferahlıyor . Yoksa , topunuzu içeri atmak işten bile değil ...	DC
Bu konuda en fazla yorum yapan köşe yazarlarının isimlerini	de	veren Bahçeli , haber ve yorumların büyük çoğunluğunun partisinin aleyhine olduğunu belirtti .	NDC
Siz nasıl da serbestçe yorumlarınızı yazıyorsanız , bırakın	da	o da kendine ait hislerini düşüncelerini yazsın işte .	DC
Görevi hâkimlik , ama kendisine fazla hâkim olamadığı çok açık . Mesaj yollamıyor	da	, zabıt kâtibine tezkere yazdırıyor sanki .	DC
Dövüşenler de var aramızda Geçen 1 Mayıs günü meğerse İzmir'de neler olmuş	da	haberimiz yok . Av. Senih Özay , emniyet güçlerinin kendisini miting alanına sokmamasının nedenini bir dilekçeyle İzmir Valiliği'nden sormuş .	DC
AB üyesi ülkelerin dışişleri bakanlarından oluşan AB Genel İşler Konseyi'nin bugün Brüksel'de yapacakları toplantıda Türkiye'nin tepkisini ne derecede dikkate aldıkları	da	görülmüş olacak . Ankara'da bu çalkantılar yaşanırken bugün kesinleşecek olan KOB'a verilecek cevap , koalisyon liderlerinin yapacağı görüşmeler ve Perşembe günü Cumhurbaşkanı Sezer , Başbakan Ecevit , Dışişleri Bakanı İsmail Cem , Genelkurmay Başkanı Orgeneral Kıvrıkoğlu ve Dışişleri müsteşarlarının yapacakları zirvenin ardından belirlenecek .	NDC
Beyza ' nın Kadınları az kalsın bomba gibi film olacakmış	da	direkten dönmüş . Ama önce yüksek müsaadenizle , filme gidene kadar başımıza gelenleri çiziktireceğim .	DC
Ayrıca istepne lastiği de yine bu düşünülerek yoktu . Neyse itiraz ettim	de	stepne lastiği verdiler fakat bu seferde arabayı ilk aldığımda verdikleri otomatik lastik şişirme setini geri aldılar .	DC
Almanya ' da Nazizm ' in yaptıklarına karşı bu devletin kuruluşuna el vererek , bütün Hıristiyan Batı , Ortaçağ ' dan beri işleyen sicilinde bu kategoriye (  antisemitizm  ) giren sabıkalarını temizleme yolu bulacağına inanmıştı . Büyük ölçüde buldu	da	. Ama o aşamada kendi antisemitizm dosyasına sünger çeken Batı , İsrail'e verdiği armağanı gene başkasının kesesinden yapmakta kusur etmiyordu .	DC
Kıbrıs Konusunda Tartışmak yasak mı ?  Biz Kıbrıs hakkında ne biliyoruz	da	tartışıyoruz  ? Haydi , birşeyler bildik diyelim , ama birileri var ki tartışmayı hep aynı konuya götürüyorlar .	DC
İçerdiği pek çok yararlı yöntemin yanı sıra , Oğlunuzla Konuşmalar'ın belki	de	en önemli hediyesi , erkek çocuklarımızla , ne hissetikleri hakkında konuşmamıza olanak sağlaması .	NDC
Ayrıca çekmiş olduğunuz video , fotoğraf ya da diğer türdeki verileri hem cep telefonundan bilgisayarınıza hem	de	bilgisayarınızdan cep telefonunuza aktarabilirsiniz . Bu ürünü kullanabilmek için bilgisayarınızda USB girişi bulunmalıdır .	NDC
Halbuki o gemide 900 İngiliz denizci öldü . Hiçbirisi son ana kadar görev yerini	de	terketmedi . Bizde bu dirayet oluşmuyor .	DC
Türkiye'nin en karanlık dönemine imza atanlardan biri , birkaç yıl hapis yattıktan sonra salındı . Gerçi bütün o olaylar içinde adı geçenlerden hapishanede kalan	da	bilindiği kadarıyla yok . Ağca , Abdi İpekçi'yi tek başına öldürmedi , askeri hapishaneden tek başına kaçmadı	NDC
İkincisi , Birleşmiş Milletler Güvenlik Konseyi'nin kararlarıyla bir devlete karşı yaptırım uygulanacaksa , ekonomik yaptırım da olabilir ya da askeri bir yaptırıma	da	müracaat edilebilir . Yedinci kısma göre alınan kararlara uyulması zorunluluğu var .	DC
Dünya Faaliyet Programı'nda var olan durumun yanı sıra ideal olan duruma	da	yer verilmiş ve bazı çözüm önerilerinde bulunulmuştur .	NDC
Ancak , basitleştirmenin tehlikeleri göze alındığında , günümüz dünyasındaki temel bölünme konusunda açıklama gücü çok daha üstün bir teori var . O	da	giderek globalleşen dünyada temel mücadelenin iki zıt zihniyet arasında olduğuna dair .	DC
Ben zaten haftada iki gün çalışıyorum . Rolüm çok değil . Diğer zamanlar	da	beraberiz . İçimizde en rahatı Ali aslında .	DC
Dönüp dolaşıp yine aynı ruh haline büründüğüm için kendime çok kızıyorum . Bu nasıl bir iş  ? Aslında kafayı yedim	de	, haberim mi yok  ?	DC
Karşılaşmanın 39. dakikasında çıkan tartışma sonrası , Üzülmezspor'un kalecisi Barış'ın , rakip takım oyuncusu Murat Erdoğan'a tokat atması üzerine çıkan kavgaya diğer futbolcular	da	karıştı . Kırmızı kartla oyun dışı kalan Barış , kendisine küfür ettiği iddiasıyla rakip takım taraftarlarının bulunduğu tribüne yöneldi .	NDC
Ben de yaparım , diyor musunuz ? Diyorsanız , cevabım hazır : Kolaysa yap	da	görelim . Hayatın ilk ...	DC
ABD Tarım Bakanlığı yetkilileri , ülkede yine olası bir deli dana vakasına rastlandığını duyururken , durumun kesinlik kazanmamasına rağmen sığır fiyatları ve borsada sığır ürünleri satan şirketlerin hisseleri düştü . Etin tüketici piyasalarına girmediği	de	belirtildi . ABD'de Haziran başından bu yana üçüncü kez deli dana şüphesiyle bazı etlerde ayrıntılı testler yapılıyor .	DC
Çevirecek dizi veya film mi kalmadı	da	bu diziyi çeviriyorsun sen .	DC
Böyle hiç anlaşılmaz ve korkutucu geliyorlar ama bir şey yok , şarkı ya	da	ses dosyaları yani bunlar . 3D Surround Ses 3 boyutlu saran ses demek .	NDC
Filistin yönetiminin kontrolü altında olması ... Dünyanın en hareketli dolayısıyla	da	en belalı coğrafyasının ortasında yaşamak kolay iş değil . Başka ülkelerin tek boyutlu bakabilecekleri meselelere Türkiye'nin kılı kırk yararak ve çok ...	NDC
Evet , bu düşünce özgürlüğünün önünde önemli engellerden birisiydi . Türkçe dışında ya	da	kanunun öngördüğü diller dışında bir dilde düşüncesini ifade etmek istiyorsa insanla bu konuda yasak getirilebiliyordu .	NDC
Yanda fotoğrafını gördüğünüz köpek ne bir film ne de reklam oyuncusu . Zaten dünyanın her tarafında fotoğraflarının olduğundan	da	habersiz . Üstelik ismi hemen hemen bütün dünya basınında yer aldı .	DC
Sizi kim iyi dans ettiğinize ikna etti	de	yarışmalara saldı kardeşim .	DC
Turizmde marka dönemi Sektördeki olumlu gelişmeler karşısında grup olarak yatırımlarına	da	hız verdiklerini belirten Tamince , Bodrum otelimizi bu ay hizmete açtık . 2004 yılında Kemer'deki otel projemiz devreye girecek . Ayrıca Marmaris'te de yatırım planlıyoruz dedi .	NDC
Sayın Kansu bu embriyonik hücrelerin kök hücrelerin elde edilmesi konusunda işte tartışmalar yaşanıyor . Belki bu konuda yanlış anlaşılmalar	da	olabiliyor . Bizim haberimizde vardı ben dikkat ettim embriyondan ziyade biz de cenin gösterdik .	DC
Amerika ne yapsaydı diye sormak mümkün , soruluyor	da	zaten ... 11 Eylül'de evlatlarını kaybeden Amerikalılar'a , evlatlarının zaten çoğunu yitirmiş , kalanlarını da yitirecek Afganlar eklenecek .	DC
Taraflar iyi anlayış , karşılıklı güven ve normal şartlara dönüşü sağlamak için her iki tarafın alacağı pratik önlemlere uymayı kararlaştırmışlardır . Kıbrıs Cumhuriyeti'nin askerden arındırılması konusu	da	görüşmelerde ele alınacaktır . Kıbrıs'ın kısmen veya tamamen başka bir ülkeye bağlanması , taksimi veya ayrı iki devlet halinde olmasına karşı , bağımsızlığı , toprak bütünlüğü ve egemenliği garanti altına alınacaktır .	NDC
Bir ara hatırlatın	da	, Kurtlar Vadisi ile ilgili yazılanlardan en çok güldüklerim başlıklı bir brifing vermeye çalışayım sizlere	DC
Küresel kozmetik pazarının büyüklüğünün 150 milyar doları aştığını , Türkiye'de ise pazar büyüklüğünün henüz 1.5 milyar dolar olduğunu söyleyen Dündar , Yani dışarıdaki pazar Türkiye'deki pazardan 99 kat daha büyük . Bu pazardan Türk firmalarının	da	daha fazla pay alabilmeleri için Ar - Ge ve pazarlamaya daha fazla bütçe ayırmaları gerekiyor .	NDC
Ben de cevap verdim sana . Sorun spontaneydi , hoşuma	da	gitti . Ama canlı yayında bir daha sordun .	DC
Yani Çınar kedi falan diyoruz	da	bu dört ayak durumları benim aklımı karıştırıyor !	DC
Önceden gerekli tanıtımın yapılması şartıyla , bizde de cazip bir ortamın varolduğunu düşünüyorum . Özellikle	de	kara teslim olduğumuz bu sevimsiz karakış günlerinde .	NDC
Kıbrıslı Türkler izolasyonların esas olarak Avrupa ile KKTC limanlarından doğrudan ticaret yapılabilmesi ve doğrudan uçuşların başlamasıyla kalkabileceğini belirtiyor . Yeni hükümetin , izolasyonların kalkması için gerekli olan bu adımların hayata geçmesi yönünde	de	yoğun bir diplomasi trafiği yürütmesi gerekiyor .	DC
Şu anda bu kadıncağıza umut vermeyelim . Belki ben de yardım edemeyebilirim ya	da	başarılı olamayabilirim . Bir de benden dolayı üzüntü çekmesin .	NDC
Süper Lig şampiyonunu belirleyen Fenerbahçe - Galatasaray maçından beri , beyninde bir kurşunla yatan 15 yaşındaki Tayfun Arıcı için ise belki	de	değişen tek şey , hiç bir sosyal güvencesi olmayan ailesinin hastane ve eczanede biriktikçe biriken borcu olacak .	NDC
Haydi biz burada Rize çayını bulamıyoruz	da	mecburen ak çayla , gök çayla idare ediyoruz , ya Türkiye’de fincanda soğuk çay içenlere ne demeli ?	DC
Volkan ' ın , Ümit Karan ' ın yumrukları cezasını buldu	da	kaleci Mondragon ' un yaptıklarına ne demeli .	DC
İstersen YTL ile ilgili sana özel seans yapayım . Bir kere dinlemiştin	de	ne güzel sorular sormuştun . Ben de vakit bol kaç kere yeterse sana o kadar anlatayım .	DC
Barışa bir fırsat tanınmalıdır . Barışçıl yöntemler henüz tüketilmiş	de	değildir . Bölgede meydana gelecek bir çatışmanın , Irak'ı , Türkiye'yi ve bölge ülkelerini olumsuz etkileyeceğini vurgulayan Sezer , Irak'ı sorumlu davranmaya davet etti .	DC
Uzanların arşivinde kasedi olan Yargıtay üyesinin Ahmet Köksal olduğu , Köksal'a ait bu kasedin	de	Akşener tarafından deşifre edilen kasetler arasında bulunduğu öğrenildi .	DC
Çağrı ' nın profesör babası ile suçladığı Başkent Hastanesi arasında sürtüşme sürüyor	da	onun için yazdım . Hastane yetkilileri çok alındıkları sözler üzerine baba Mesut Anıl'ı mahkemeye vermeye hazırlanıyormuş .	DC
ece gürselin 5 erkek arasında kaybolduğunu söyledikten sonra ceyhun biz onda kayboluruz	da	ona bir şey olmaz dedi .  ama gerçekten de ece gürsel kayboldu .	DC
Kar haline getirilmiş buz doldurduğu bardağın içine bir miktar tekila döken barmen , biraz limon suyu eklemiş , biraz	da	portakal likörü . Marjorie bayılmış bu karışıma .	NDC
Irmak'ın ayrılışından sonra bankerlik kuruluşunun müdürü de bilgi vermekten kaçındı ve sorular karşısında Hesabı vardır da diyemem , yoktur	da	diyemem . Biliyorsunuz bu konu gizlidir dedi .	DC
sen de hangi futbolcunun çocuğusun açıkla	da	kamuoyu aydınlansın .	DC
Böyle bir şeyi ben kabul etmiyorum , ben bunu özerklik olarak da görmüyorum. İnşallah sonu iyi biter . Yüce parlamentoya	da	güveniyoruz , onlar da sağ duyulu insanlar komisyondaki arkadaşlarımız , ağabeylerimiz .	NDC
Uzman personelin içinde sosyalite uzmanlarını , psikologları , çocuk gelişimcileri sayabilirim . Rehabilitasyon merkezleri içinde fizyoterapistleri	de	ekleyebilirim . Dolayısıyla şimdi eğitim konusunda şunu öneriyoruz	DC
Nazım Hikmetof Yoldaş bizim büyük şair ve büyük vatanperverimiz Namık Kemal`e sövüyor	da	o edebiyatçılardan hiçbirisinin kılı kıpırdamıyor .	DC
Ama Blair de oralı değil . İslamiyet'in farkı ise , tam	da	kedinin yarı kutsanmışlığı , Hz. Muhammed'in kedi sevgisiyle oluşan dokunulmazlığı .	NDC
Serdengeçti , yüksek enflasyonla mücadeleye de değinerek , dönem dönem yüzde 12'ler gibi bir büyümenin sağlandığını , arkasından	da	krizle birlikte eksi büyüme yaşandığını söyledi .	NDC
Oğlum da bunun üzerine kimsenin vekâletini almadı . Oğluma kefilim , bu dava nedeniyle kimseden para	da	almamıştır . Ben de bu konuyla ilgili yargıda kimseyle görüşmüş değilim .	NDC
Teşekkür ediyoruz . Bugün	de	programımızın sonuna geldik .	NDC
Kimi zaman , Nasıl oluyor da yanlış olmuyor , olmadı bile dersiniz . Kendini size bile unutturan kontrol gereçleri , kontrol melekleri iş üstündedir	de	, ondan . Necdet işte o efsunlulardandı .	DC
Türkiye'deyse AIDS'liyi yüzde yüz reddetme var , hastalığı bilmiyorlar . Zannediyorlar ki öpüşmeyle de , hapşırmayla	da	geçer . Botswana'da 6,5 yıl yaşadım .	NDC
Aralarında iki küçük çocuğun da bulunduğu 192 yolcu ve 9 kişilik uçuş ekibini taşıyan uçak yakıt ikmali için Atina'ya indirildi . Başbakan Tayyip Erdoğan ve Ulaştırma Bakanı Binali Yıldırım'ın	da	katıldığı korsanı ikna etme çabaları sonuç verdi ve korsan bütün yolcuları serbest bıraktı .	NDC
ECRİ aynı zamanda , ibadet yerlerinin açılması önündeki idari engellere , rahip sayısının yetersizliğine ve bazı cemaatlerin mensuplarının sayısının azalıyor olmasına	da	değinmiştir . ECRİ , Türk yetkilileri azınlıktaki dini gruplarla bu türden ve azınlık cemaatlerinin karşılaşabilecekleri buna benzer başka sorunlar hakkında diyalog kurmaya çağırmıştı .	NDC
sizin sorduğunuz sorulara ben cevap verirsem işinize gelmeyebilir , gelebilir	de	. Benim size her şeyi söylemem doğru değildir .	DC
İşte onu bulamadım	da	beyazın tersi diye söyledim .	DC
Önerilen isimlerin ne TÜBİTAK başkanı olabilecek bilimsel yeterlilikleri var ne	de	vizyonları . Daha da rahatsız edici olan , söz konusu isimlerin birtakım ideolojik bağlantı içerisinde görünüyor olmaları ...	NDC
Sonuçları heyecanla bekliyorum , soğukkanlılığımı	da	kaybetmiş değilim .	DC
Çekini ödemeyen veya icrada gerekli mal beyanında bulunmayan borcunu ödemekle kurtuluyordu , şimdi hiç kimse borcunu ödemeyecek , alacaklı	da	yasadışı yollara başvuracak , bu hal topluma yarar mı getirir , zarar mı ?	DC
Hiçbir şeyi tayin etmedim , hiç düşünmedim	de	. Hangi film ya da roman kahramanı size benzer .	DC
Eşim Selahattin , işini bitirdikten sonra ertesi gün eve gelecekti Evde bulunduğu zaman zarfında telefon ile hiç kimse ile görüşmedi . Kimseyi	de	aramadı . yemeğini yiyip çıktı .	DC
Aman ne tatlı sesin varmış senin ! Hele gel	de	seni bir bağrıma basayım .	DC
İlgisizlik çağı seçmenlerinin , parti içi demokrasi veya parti programına göre belli bir partiye yöneldikleri görüşü de abartılıdır . Gerçekten	de	solun yenileşme , bütünleşme ve kitleselleşme konusunda ciddi sıkıntıları bulunmaktadır .	NDC
Başlık parası'nı kazanamamıştım ! Babam borç etti	de	ancak evlenebildim . Dönelim iş hayatına .	DC
Konu stres olunca ne yapacağımızı biliyoruz	da	, sorun nasıl yapacağımız . Motivasyonu nasıl yaratacağımız , nereden başlayacağımız ve ipin ucunu kaçırmadan nasıl devam edeceğimiz ...	DC
haberi okudum ve gözlerime inanamadım . mail attım	da	cevabın çok doyurucu olacağını sanmıyorum .	DC
sen vahi beyi al götür , biraz çabuk ol	da	baban sarhoşken senin burada olduğunu anlamasın .	DC
Hürriyet geçen yıl yanlışlıkla kamelya demişti	de	Türk basınına tartışacak malzeme çıkmıştı .	DC
Diyarbakır'da 21 , Adıyaman'da 33 fabrikanın açılışı yapılmıştır . Bunların devamı	da	gelecektir . Esas mesele , toplumun ekonomik özgüvenini sağlamak , öyle sanıyorum ki terörün kökünü kazımakta da önemli bir adım olacaktır .	DC
Bugün İstanbul'un birçok semtinde emlak fiyatları dörtte bir değerine düşerken ve buna rağmen alıcı bulamazken , hem emlak vergisi oranının artırılması , hem	de	arsa değerlerinin fahiş olarak takdir edilmesi soygundan başka bir şey değildir .	NDC
Umarım ki , akıllarını başlarına alırlar	da	kendi sonları da daha öncekiler gibi olmaz .	DC
film gerçekten çok sağlamdı bence . o beğenmeyen arkadaşlara bi sözüm olacak yapabiliyorsak böyle bi film bizimkiler yapsın	da	görelim . film fantastik - bilimkurgu formatında oldsuğu için efekt lerin olması gayet doğal Gerçekten başarılı bir yapım ...	DC
Asıl olan hep üç puandır . Üç puan alalım	da	tenkit edileyim . Maçın anahtarı iki farklı skoru bulmakta yatıyor .	DC
Sakın annem duymasın ama hızı çok seviyorum , bana bu yüzden çok kızıyor . Zaten yaptığım spordan	da	belli herhalde hızı sevdiğim .	NDC
NTV'ye konuşan Başbakan Yardımcısı Abdüllatif Şener , Böyle bir uygulama olmaz . Bu hem sosyal barışı , hem	de	hükümetin uyguladığı programı bozar dedi .	NDC
Hülya Avşar'ın yeni dizisinin tutacağını düşünmüyorum . Gülben Ergen ve Ebru Gündeş'in televizyona yaptığı işler	de	tutmaz . Çünkü özel hayatlarıyla çok gündemdeler .	DC
Bizim haricimizdeki insanlar söyleyecek . Böyle bir şeyi ben kabul etmiyorum , ben bunu özerklik olarak	da	görmüyorum . İnşallah sonu iyi biter .	DC
Velhasıl ; hadi karanlık demeyeyim	de	, tuhaf bir gelecek bizi bekliyor .	DC
Filmin sonunda , çocuğu olmayan kız kardeş , ayrıldığı kocasıyla seviştikten sonra ölüyordu , sevmediği adamla evlenen kız kardeş	de	, sevdiği adamla sevişip , kocasından iyi bir dayak yedikten sonra , kendi toplumunu terk ediyordu .	NDC
İnsanın dans ederken karakterini ortaya koyduğunu düşünmeye başladığı ilk dönemlerde Vural , bu konudaki yorumlarını aktarmış çevresindekilere . Siz aslında şöyle biri misiniz diye sorduğunda	da	olumlu yanıt almış . Daha sonra da bu bağlantının nedenlerini araştırmaya başlamış .	NDC
Bu sistem gelişen dalıcı donanımına uyumlu olarak dalış eğitim tekniklerini sürekli geliştirmiş ve güncellemiştir . Profesyonel dalıcıların görüş ve istekleri	de	bu yöndedir . Sınıf havuz ve açık deniz çalışmalarıyla tüm dünyada geçerli başarılı bir standart oluşturmuştur .	DC
Şair şaraptan başka tütün ve afyondan da bahsetmektedir . Şair şiirlerinde meyhane ve meyhaneciye	de	yer vermiştir . Yürek temizliğiyle meyhanenin eşiğine yüzünü sürenlerin çoğunun oraya mutsuz gelip güler yüz ile gittiğini söyleyerek meyhaneyi bir bakıma insanlara huzur ve mutluluk veren Allah ın huzuruna benzetiyor .	NDC
Bu nedenle günümüzde bu tür çalışmalara büyük ihtiyaç duyulduğu düşünülürse bu sözlük oldukça önemlidir . Bu sözlüğün diğer bir yönü 	de	günlük dilde çok kullanılan kelimelerden oluşmasıdır . Bu açıdan da eser dikkate değer bir çalışmadır .	DC
Bayağı güzel bir yerde konumlanmış bir yapı . Buranın askeri kampı	da	çok güzelmiş . Oldukça geniş bir alana yayılmış .	NDC
Eserde konuya geniş bir çerçeveden bakılmış olup anketlerde iş yeri sahiplerinin ve müşterilerin eğitim durumlarından iş yerinin bulunduğu semte kullanılan ismin yabancı mı yoksa Türkçe kökenli mi olduğuna kadar pek çok konuda çeşitli sorular yer almıştır . Eserin sonunda dilimizde yaşanan bu çarpıklığa ait fotoğraflara	da	yer verilmiştir . Dilin bugün yaşadığı çıkmazda dilde uygulanan bazı yanlış politikaların da etkili olduğunun altını çizilmiştir .	DC
Dilin bugün yaşadığı çıkmazda dilde uygulanan bazı yanlış politikaların da etkili olduğunun altını çizilmiştir . Bu konuda basından alınan bazı yazılara	da	yer verilmiştir . Kitaba alınan yazılardan birinde Şiar Yalçın bu durumu şöyle dile getirmektedir .	DC
Giresun çok güzel bir yer . Ben	de	gittim . Herkese tavsiye ederim .	DC
Bayağı güzel bir manzarası var . Buranın bir pansiyonu	da	var . Kalınabilir . Ama Büyükada şehre çok uzak .	NDC
Türkçenin bütün söz varlığını kapsayan ve kullanıcılara sunan kolay kullanılır bir sözlük olacaktır . Yabancı dillerde	de	benzer sözlükler bulunmaktadır .	DC
Bu eserleri kullanıcılara özgürce sunacak yerimiz olmadığı gibi kütüphane deposunda da kitaplarımızı koyacak yer artık kalmamıştır . Ayrıca çağdaş kütüphanelerde eserler sayısal ortama aktarılarak kullanıcılara sunulmaktadır . Bugünkü binamız bu imkânı	da	sağlayamamaktadır . Yirmiyi aşkın çalışma grubumuzun aynı zamanda toplanmalarını ve çalışmalarını sağlayacak yeterli sayıda toplantı odamız da bulunmamaktadır .	DC
Bunun gibi yıl sonlarında askerî siyasî kültürel ve bilimsel olayların değerlendirildiği de göze çarpıyor . Bu anketlerde doğal olaylar	da	geçer .  Son yıllarda ülkemizde de türlü alanlarda ün yapmış kişileri seçmek amacıyla jüriler kurulduğuna tanık olmaya başladık .	DC
İnternette sanal virtual alışveriş merkezleri kuruldu böylece bilgisayar aracılığıyla alışveriş yapmak mümkün hale geldi . Bazı gazetelerimiz internetten	de	yayın yapmaya başladı . Kısacası Türk milleti olarak interneti benimsemiş ve sevmiştik .	DC
33 yeni eserin baskı işlemleri ise tamamlanmak üzeredir . Bu eserler	de	bu yıl içerisinde yayımlanmış olacaktır .	DC
Bu yılın Aralık ayında ise Türk Dili 600. sayısına ulaşacak . Bu sayı 	da	özel sayı olarak yayımlanacaktır .	DC
Basit araçların aletlerin ve düşüncelerin bir araya gelmesiyle ortaya konan bu olgular veya veriler basit hatta naif biçimleriyle göze çarparlar . Bazen bu tür eserlerin ilkel primitif olarak adlandırıldıkları	da	olur . Kişi dilindeki veya elindeki malzemeyi en kolay bir yöntemle kullanmış ve çok basit gibi görünen bir biçimle o veriyi meydana çıkarmıştır .	DC
Birinci elden derlenen halk bilimi malzemesinin sağlam olmasına karşılık değişik biçimlerde karşımıza çıkan metinlerde bazı tutarsızlıklar ve bozukluklar göründüğünde bu metnin herhangi bir biçimde değiştirildiği ihtiyaca uygun duruma getirildiği veya üzerinde çeşitli amaçlarla oynandığı anlaşılmaktadır . Böyle bir durumda ele geçirilen malzemeye pek güven duyulmayacağı	da	açıktır . Dil ve folklorun örtüştüğü veya kesiştiği bu alanda elde edilen malzemenin özelliklerini daha doğrusu birinci elden özellikler ile bunlara karşılık ikinci elden özellikleri aşağıda ayrı ayrı göstererek dil ve folklor araştırmacılarına bir parça kolaylık sağlamak malzemeyi derlerken denetim ve karşılaştırma işlemlerini de bu özellikleri göz önünde tutarak yapmalarına imkân vermek istiyorum .	DC
Atatürk sınıfa girmiş geçmiş arkaya oturmuş . Maiyetindekiler 	de	kenarda sıralanmışlar .	DC
80 yıldan beri bu dile hiç kelime girmedi mi	de	bir tane bile kelime artmadı .	DC
Yüksek Kurum Başkanının dediği gibi başka sesler de olacaktır . Tenkit	de	edileceğiz . Haklı iseler biz düzelteceğiz haksız iseler doğru bildiğimiz yolda yürüyeceğiz .	DC
Livaneli nin kul aşı açıklaması da açık bir halk etimolojisi örneğidir . O açıdan Livaneli nin gulaş a ilişkin açıklaması çarpıcıdır . Ancak bu açıklama salt çarpıcı olmakla kalmıyor . Gulaş etimolojisi birçok bakımdan düşündürücü bir örnektir	de	. Bozuk imajımızı düzeltmek ve ülkemizin aydınlık yüzünü göstermek amacına yönelik çaba ve girişimlere katılıyoruz .	DC
Yayımlanan şiir ve yazıların sayısı kadar yayımlanmama kararı verilen şiir ve yazıların bulunduğunu belirtmek gerekir . Tanınmış kimi şairlerin şiirlerinin yayımlanmadığı	da	eleştiri konusu edilmektedir . Dergimizde ancak gönderilen şiirler değerlendirilmekte ve yayımlanmaktadır .	DC
Bes ne üçün ondan imtina ettin örneğinde ise Farsçadan Türkçeye geçen bu kelime peki öyle ise anlamındadır . Bu kelime Azerbaycan Türkçesinde elbette anlamında	da	kullanılır . Kanaatime göre bu Türkiye Türkçesinde pes biçiminde kullandığımız kelimedir .	DC
Evet eleştirilmesine eleştirilmiştir	de	devrim sözünün neden yasaklanır olduğu açıklanmamıştır .	DC
Doğal olarak kendi kültürümüz içinde doğrudan ulaştığımız yeni bir kavramı kendi dilimizin imkânlarıyla işaretlemeyi deneriz . Çok kere başarılı	da	oluruz . Ancak bir başka kültür içinde ulaşılmış ve o kültürün taşıyıcısı dilin imkânlarıyla işaretlenmiş bir kavramı yeniden işaretlemek iki dili bilen bir kimse için fazladan bir düşünme ve karar verme zamanı alarak haberleşmenin hızını keseceğinden gereksiz ve zorlama bir davranış olarak görülür .	DC
İlk olarak askerî alanda kendini gösteren Batılılaşma hareketleri zaman içerisinde hukuk eğitim sanat ve buna benzer alanlarda da görülmeye başlamıştır . Kuşkusuz bu toplumsal değişmelerden edebiyat	da	nasibini almıştır . Tanzimat döneminden bu yana verilen eserlere baktığımızda edebiyatçıların da bu konuya duyarsız kalmadığını görüyoruz .	DC
Önemli sözlerin adların veya kısaltmaların yanlış anlamaya yol açmadan doğru biçimde karşı tarafa aktarılmasında kullanılan yöntemlerden biri de kodlamadır . Kodlamanın ortak sözlerle yapılması 	da	esastır . Uluslararası kodlama sisteminde A için alfa B için bravo C için charli D için delta T için tango gibi kodlar kullanılır .	DC
Bir meslektaşımız ulusal ve uluslararası kodlama sistemleri üzerine bir araştırma yapmış bu araştırma dergimizde	de	yayımlanmıştır . Ülkemizde ise ne yazık ki kodlamada bir birlik görülmemektedir .	DC
Haçlı birliğine girmek istemiyorum . Atalarımın tarihte paramparça ettiği haçı	da	istemiyorum . Haçlıların kurduğu ve bir hristiyan kulübü olan Avrupa Birliği nden tiksiniyorum nefret ediyorum .	DC
Ülkemizde Alexa tool bar yaygın değildir . Hatta belli çevreler reklama yönelik dışında bilinir	de	değildir . Alexa nın sonuçları ancak bu kısıtlı çevrenin kullanım alışkanlıklarını verdiği için doğru sonuç vermiyor .	NDC
Güreşmekte ok ve yay yapmada üstüne yoktu . Harpten hoşlanmakla beraber çok ince bir ruha	da	sahipti . Çok mütevazi bir kişiliğe sahip olan Yavuz Sultan Selim her öğün yemekte tek çeşit yemek yerdi ve ağaçtan tabaklar kullanırdı .	DC
Onunla gurur duyarım gördüğüm yerde turistlerle konuşması için baskı yaparım . Okusun işte ne güzel . Boş durmasın	da	. Boynuz kulağı geçer derim .	DC
O dönemde basını dikkatle takip ettim . Bir sürü kişiyle konuşmaya giriştim pek çok tahminim	de	doğru çıktı . Bir dolu gizli nokta olduğunu düşündüm onlar hala açıklanmadı .	DC
Kuzey Amerika da titiz bir anneanne bunu uydurmuştur torunları korksun	da	yatağa ayakkabıyla girmesin diye .	DC
Olduğum gibi davranırım eğer geçinemeyeceksek baştan belli olsun	da	evi tutmayayım . Aşırı titiz ev sahiplerine karşı ön yargılıyım o evi tutmaktan vazgeçerim .	DC
Pop ikonu olmak , ne yaparsanız yapın , bir şekilde etliye sütlüye karışmamanızı da gerektiriyor nedense . Bülent Ersoy	da	bu durumu kabullenmiş bir şekilde magazin aromalı tartışmalara kafa göz dalıp dalıp çıkıyor .	DC
Yazları Türkiye'ye gelir , Türk arkadaşlarıyla Göcek'te yelken açar , Ege'de balık avına çıkardı . Türk arkadaşlarına	da	şöyle söylemleri olurdu :	DC
Goldman Sachs ve Morgan Stanley Dean Witter liderliğinde oluşturulacak uluslararası sendikasyon tarafından halka arz edilecek . Turkcell'in halka arzda önem taşıdığını belirttiği 10 maddeye	de	değinilen SPK yazısında , Şirket'in söz konusu talepleri , ( 8 ) no'lu madde dışında kurulumuzun 11 Mayıs tarihli toplantısında görüşülerek kabul edilmiştir denildi .	NDC